C++|C++是C语言的继承，它既可以进行C语言的过程化程序设计，又可以进行以抽象数据类型为特点的基于对象的程序设计，还可以进行以继承和多态为特点的面向对象的程序设计。C++擅长面向对象程序设计的同时，还可以进行基于过程的程序设计，因而C++就适应的问题规模而论，大小由之。[1] C++不仅拥有计算机高效运行的实用性特征，同时还致力于提高大规模程序的编程质量与程序设计语言的问题描述能力。[2] 
Caffe|Caffe，全称Convolutional Architecture for Fast Feature Embedding。
CUDA|CUDA(Compute Unified Device Architecture)，是显卡厂商NVIDIA推出的运算平台。 CUDA™是一种由NVIDIA推出的通用并行计算架构，该架构使GPU能够解决复杂的计算问题。 它包含了CUDA指令集架构（ISA）以及GPU内部的并行计算引擎。 开发人员现在可以使用C语言来为CUDA™架构编写程序，C语言是应用最广泛的一种高级编程语言。所编写出的程序于是就可以在支持CUDA™的处理器上以超高性能运行。CUDA3.0已经开始支持C++和FORTRAN。
Hadoop|Hadoop是一个由Apache基金会所开发的分布式系统基础架构。用户可以在不了解分布式底层细节的情况下，开发分布式程序。充分利用集群的威力进行高速运算和存储。[1] Hadoop实现了一个分布式文件系统（Hadoop Distributed File System），简称HDFS。HDFS有高容错性的特点，并且设计用来部署在低廉的（low-cost）硬件上；而且它提供高吞吐量（high throughput）来访问应用程序的数据，适合那些有着超大数据集（large data set）的应用程序。HDFS放宽了（relax）POSIX的要求，可以以流的形式访问（streaming access）文件系统中的数据。Hadoop的框架最核心的设计就是：HDFS和MapReduce。HDFS为海量的数据提供了存储，则MapReduce为海量的数据提供了计算。[2] 
Java|Java是一门面向对象编程语言，不仅吸收了C++语言的各种优点，还摒弃了C++里难以理解的多继承、指针等概念，因此Java语言具有功能强大和简单易用两个特征。Java语言作为静态面向对象编程语言的代表，极好地实现了面向对象理论，允许程序员以优雅的思维方式进行复杂的编程[1] 。Java具有简单性、面向对象、分布式、健壮性、安全性、平台独立与可移植性、多线程、动态性等特点[2] 。Java可以编写桌面应用程序、Web应用程序、分布式系统和嵌入式系统应用程序等[3] 。
lua|Lua[1]  是一个小巧的脚本语言。是巴西里约热内卢天主教大学（Pontifical Catholic University of Rio de Janeiro）里的一个研究小组，由Roberto Ierusalimschy、Waldemar Celes 和 Luiz Henrique de Figueiredo所组成并于1993年开发。 其设计目的是为了嵌入应用程序中，从而为应用程序提供灵活的扩展和定制功能。Lua由标准C编写而成，几乎在所有操作系统和平台上都可以编译，运行。Lua并没有提供强大的库，这是由它的定位决定的。所以Lua不适合作为开发独立应用程序的语言。Lua 有一个同时进行的JIT项目，提供在特定平台上的即时编译功能。Lua脚本可以很容易的被C/C++ 代码调用，也可以反过来调用C/C++的函数，这使得Lua在应用程序中可以被广泛应用。不仅仅作为扩展脚本，也可以作为普通的配置文件，代替XML,ini等文件格式，并且更容易理解和维护。[2] Lua由标准C编写而成，代码简洁优美，几乎在所有操作系统和平台上都可以编译，运行。[2] 一个完整的Lua解释器不过200k，在目前所有脚本引擎中，Lua的速度是最快的。这一切都决定了Lua是作为嵌入式脚本的最佳选择。[2] 
numpy|NumPy系统是Python的一种开源的数值计算扩展。这种工具可用来存储和处理大型矩阵，比Python自身的嵌套列表（nested list structure)结构要高效的多（该结构也可以用来表示矩阵（matrix））。据说NumPy将Python相当于变成一种免费的更强大的MatLab系统。[1] 
Paddle|
Scala|Scala是一门多范式的编程语言，一种类似java的编程语言[1] ，设计初衷是实现可伸缩的语言[2] 、并集成面向对象编程和函数式编程的各种特性。
SPARK|Apache Spark 是专为大规模数据处理而设计的快速通用的计算引擎。Spark是UC Berkeley AMP lab (加州大学伯克利分校的AMP实验室)所开源的类Hadoop MapReduce的通用并行框架，Spark，拥有Hadoop MapReduce所具有的优点；但不同于MapReduce的是Job中间输出结果可以保存在内存中，从而不再需要读写HDFS，因此Spark能更好地适用于数据挖掘与机器学习等需要迭代的MapReduce的算法。Spark 是一种与 Hadoop 相似的开源集群计算环境，但是两者之间还存在一些不同之处，这些有用的不同之处使 Spark 在某些工作负载方面表现得更加优越，换句话说，Spark 启用了内存分布数据集，除了能够提供交互式查询外，它还可以优化迭代工作负载。Spark 是在 Scala 语言中实现的，它将 Scala 用作其应用程序框架。与 Hadoop 不同，Spark 和 Scala 能够紧密集成，其中的 Scala 可以像操作本地集合对象一样轻松地操作分布式数据集。尽管创建 Spark 是为了支持分布式数据集上的迭代作业，但是实际上它是对 Hadoop 的补充，可以在 Hadoop 文件系统中并行运行。通过名为 Mesos 的第三方集群框架可以支持此行为。Spark 由加州大学伯克利分校 AMP 实验室 (Algorithms, Machines, and People Lab) 开发，可用来构建大型的、低延迟的数据分析应用程序。
TensorFlow|TensorFlow是谷歌基于DistBelief进行研发的第二代人工智能学习系统，其命名来源于本身的运行原理。Tensor（张量）意味着N维数组，Flow（流）意味着基于数据流图的计算，TensorFlow为张量从流图的一端流动到另一端计算过程。TensorFlow是将复杂的数据结构传输至人工智能神经网中进行分析和处理过程的系统。TensorFlow可被用于语音识别或图像识别等多项机器深度学习领域，对2011年开发的深度学习基础架构DistBelief进行了各方面的改进，它可在小到一部智能手机、大到数千台数据中心服务器的各种设备上运行。TensorFlow将完全开源，任何人都可以用。
TORCH|TORCH为多义词：指可导致先天性宫内感染及围产期感染而引起围产儿畸形的病原体，它是一组病原微生物的英文名称缩写，其中T（Toxoplasma)是弓形虫，O（Others）是其他病原微生物，如梅毒螺旋体、带状疱疹病毒、细小病毒B19、柯萨奇病毒等，R(Rubella.Virus)是风疹病毒，C(Cytomegalo.Virus)是巨细胞病毒，H(Herpes.Virus)即是单纯疱疹I/II型。
中央处理器|中央处理器（CPU，Central Processing Unit）是一块超大规模的集成电路，是一台计算机的运算核心（Core）和控制核心（ Control Unit）。它的功能主要是解释计算机指令以及处理计算机软件中的数据。中央处理器主要包括运算器（算术逻辑运算单元，ALU，Arithmetic Logic Unit）和高速缓冲存储器（Cache）及实现它们之间联系的数据（Data）、控制及状态的总线（Bus）。它与内部存储器（Memory）和输入/输出（I/O）设备合称为电子计算机三大核心部件。
分布式直流电源|分布式直流电源应用范围：小型开关站、环网柜、箱式变电站和用户终端，为二次控制线路、一次开关设备（弹簧机构真空断路器、电动负荷开关等）、通讯光端机等提供直流电源。
参数优化|参数优化是达到设计目标的一种方法，通过将设计目标参数化，采用优化方法，不断的调整设计变量，使得设计结果不断接近参数化的目标值。
图形处理器|图形处理器（英语：Graphics Processing Unit，缩写：GPU），又称显示核心、视觉处理器、显示芯片，是一种专门在个人电脑、工作站、游戏机和一些移动设备（如平板电脑、智能手机等）上图像运算工作的微处理器。用途是将计算机系统所需要的显示信息进行转换驱动，并向显示器提供行扫描信号，控制显示器的正确显示，是连接显示器和个人电脑主板的重要元件，也是“人机对话”的重要设备之一。显卡作为电脑主机里的一个重要组成部分，承担输出显示图形的任务，对于从事专业图形设计的人来说显卡非常重要。
张量|张量（tensor）理论是数学的一个分支学科，在力学中有重要应用。张量这一术语起源于力学，它最初是用来表示弹性介质中各点应力状态的，后来张量理论发展成为力学和物理学的一个有力的数学工具。张量之所以重要，在于它可以满足一切物理定律必须与坐标系的选择无关的特性。张量概念是矢量概念的推广，矢量是一阶张量。张量是一个可用来表示在一些矢量、标量和其他张量之间的线性关系的多线性函数。
性能|性能作为中药学术语应用时，泛指药物的四气、五味、归经、升降沉浮、补泻等特性和功能（在此，亦可作“效果”）。产品性能是指产品具有适合用户要求的物理、化学或技术性能，如强度、化学成份、纯度、功率、转速等。
接口|接口泛指实体把自己提供给外界的一种抽象化物（可以为另一实体），用以由内部操作分离出外部沟通方法，使其能被内部修改而不影响外界其他实体与其交互的方式。人类与电脑等信息机器或人类与程序之间的接口称为用户界面。电脑等信息机器硬件组件间的接口叫硬件接口。电脑等信息机器软件组件间的接口叫软件接口。在计算机中，接口是计算机系统中两个独立的部件进行信息交换的共享边界。这种交换可以发生在计算机软、硬件，外部设备或进行操作的人之间，也可以是它们的结合。
数值计算|数值计算 指有效使用数字计算机求数学问题近似解的方法与过程，以及由相关理论构成的学科。数值计算主要研究如何利用计算机更好的解决各种数学问题，包括连续系统离散化和离散形方程的求解，并考虑误差、收敛性和稳定性等问题。从数学类型分，数值运算的研究领域包括数值逼近、数值微分和数值积分、数值代数、最优化方法、常微分方程数值解法、积分方程数值解法、偏微分方程数值解法、计算几何、计算概率统计等。随着计算机的广泛应用和发展，许多计算领域的问题，如计算物理、计算力学、计算化学、计算经济学等都可归结为数值计算问题。
架构|架构，又名软件架构，是有关软件整体结构与组件的抽象描述，用于指导大型软件系统各个方面的设计。架构描述语言（ADL）用于描述软件的体系架构。现在已有多种架构描述语言，如Wright（由卡内基梅隆大学开发），Acme（由卡内基梅隆大学开发），C2（由UCI开发），Darwin（由伦敦帝国学院开发）。ADL的基本构成包括组件、连接器和配置。[1] 
模块化|模块化是指解决一个复杂问题时自顶向下逐层把系统划分成若干模块的过程，有多种属性，分别反映其内部特性。
矩阵|在数学中，矩阵（Matrix）是一个按照长方阵列排列的复数或实数集合[1] ，最早来自于方程组的系数及常数所构成的方阵。这一概念由19世纪英国数学家凯利首先提出。矩阵是高等代数学中的常见工具，也常见于统计分析等应用数学学科中。[2] 在物理学中，矩阵于电路学、力学、光学和量子物理中都有应用；计算机科学中，三维动画制作也需要用到矩阵。 矩阵的运算是数值分析领域的重要问题。将矩阵分解为简单矩阵的组合可以在理论和实际应用上简化矩阵的运算。对一些应用广泛而形式特殊的矩阵，例如稀疏矩阵和准对角矩阵，有特定的快速运算算法。关于矩阵相关理论的发展和应用，请参考矩阵理论。在天体物理、量子力学等领域，也会出现无穷维的矩阵，是矩阵的一种推广。
神经网络|神经网络可以指向两种，一个是生物神经网络，一个是人工神经网络。生物神经网络：一般指生物的大脑神经元，细胞，触点等组成的网络，用于产生生物的意识，帮助生物进行思考和行动。人工神经网络（Artificial Neural Networks，简写为ANNs）也简称为神经网络（NNs）或称作连接模型（Connection Model），它是一种模仿动物神经网络行为特征，进行分布式并行信息处理的算法数学模型。这种网络依靠系统的复杂程度，通过调整内部大量节点之间相互连接的关系，从而达到处理信息的目的。人工神经网络：是一种应用类似于大脑神经突触联接的结构进行信息处理的数学模型。在工程与学术界也常直接简称为“神经网络”或类神经网络。
跨平台|跨平台概念是软件开发中一个重要的概念，即不依赖于操作系统，也不依赖硬件环境。一个操作系统下开发的应用，放到另一个操作系统下依然可以运行。相对而言如果某种计算机语言不用修改代码即可做到高度跨平台，那么此语言就越抽象，硬件控制力就越低，只适合开发高度抽象的模型系统。诸如java,delphi和易语言，都已做到了跨平台。它们将可以在多种系统下开发，运行和维护。[1] 
里包恩|里包恩，日本漫画《家庭教师HITMAN REBORN!》及其衍生作品中的人物，是世界顶级的一流杀手，彭格列九代最信任杀手。受九代首领的委讬为了培养沢田纲吉成为彭格列十代首领从意大利来到日本，是杀手、最强的彩虹之子兼阿纲的家庭教师。常头戴黑帽及穿着黑色西装，帽子上有一只叫列恩的蜥蜴。对普通人相当友善，但对阿纲非常严厉。面无表情的他看起来思想单纯，其实做事深思熟虑。也是沢田纲吉最怕和敬畏的人。[1] 
ImageNet|ImageNet 是一个计算机视觉系统识别项目名称， 是目前世界上图像识别最大的数据库。是美国斯坦福的计算机科学家，模拟人类的识别系统建立的。ImageNet能够从图片识别物体，是未来用在机器人身上，可以直接辨认物品和人了。
opencv|OpenCV是一个基于BSD许可（开源）发行的跨平台计算机视觉库，可以运行在Linux、Windows、Android和Mac OS操作系统上。它轻量级而且高效——由一系列 C 函数和少量 C++ 类构成，同时提供了Python、Ruby、MATLAB等语言的接口，实现了图像处理和计算机视觉方面的很多通用算法。OpenCV用C++语言编写，它的主要接口也是C++语言，但是依然保留了大量的C语言接口。该库也有大量的Python, Java and MATLAB/OCTAVE (版本2.5)的接口。这些语言的API接口函数可以通过在线文档获得。如今也提供对于C#,Ch, Ruby的支持。所有新的开发和算法都是用C++接口。一个使用CUDA的GPU接口也于2010年9月开始实现。
RGB|RGB色彩模式是工业界的一种颜色标准，是通过对红(R)、绿(G)、蓝(B)三个颜色通道的变化以及它们相互之间的叠加来得到各式各样的颜色的，RGB即是代表红、绿、蓝三个通道的颜色，这个标准几乎包括了人类视力所能感知的所有颜色，是目前运用最广的颜色系统之一。
三维重建|三维重建的英文术语名称是3D Reconstruction.三维重建是指对三维物体建立适合计算机表示和处理的数学模型,是在计算机环境下对其进行处理、操作和分析其性质的基础,也是在计算机中建立表达客观世界的虚拟现实的关键技术。
人脸识别|人脸识别，是基于人的脸部特征信息进行身份识别的一种生物识别技术。用摄像机或摄像头采集含有人脸的图像或视频流，并自动在图像中检测和跟踪人脸，进而对检测到的人脸进行脸部的一系列相关技术，通常也叫做人像识别、面部识别。
以图搜图|以图搜图，是通过搜索图像文本或者视觉特征，为用户提供互联网上相关图形图像资料检索服务的专业搜索引擎系统，是搜索引擎的一种细分。通过输入与图片名称或内容相似的关键字来进行检索，另一种通过上传与搜索结果相似的图片或图片URL进行搜索。
光学字符识别|OCR （Optical Character Recognition，光学字符识别）是指电子设备（例如扫描仪或数码相机）检查纸上打印的字符，通过检测暗、亮的模式确定其形状，然后用字符识别方法将形状翻译成计算机文字的过程；即，针对印刷体字符，采用光学的方式将纸质文档中的文字转换成为黑白点阵的图像文件，并通过识别软件将图像中的文字转换成文本格式，供文字处理软件进一步编辑加工的技术。如何除错或利用辅助信息提高识别正确率，是OCR最重要的课题，ICR（Intelligent Character Recognition）的名词也因此而产生。衡量一个OCR系统性能好坏的主要指标有：拒识率、误识率、识别速度、用户界面的友好性，产品的稳定性，易用性及可行性等。
刷脸支付|刷脸支付，是支付宝推出的一项新功能。
势不两立|《势不两立》是一部由李·塔玛霍利指导拍摄的惊悚片。飞机失事，一群身份各异的人被困在阿拉斯加的荒野。查尔斯·莫尔斯是亿万富翁，罗伯特·格林是摄影师。寒冷、饥饿、野兽袭击·.....在绝境中，人的本性暴露无遗。忧虑、恐惧时刻啮噬着他们的心。
图像分割|图像分割就是把图像分成若干个特定的、具有独特性质的区域并提出感兴趣目标的技术和过程。它是由图像处理到图像分析的关键步骤。现有的图像分割方法主要分以下几类：基于阈值的分割方法、基于区域的分割方法、基于边缘的分割方法以及基于特定理论的分割方法等。1998年以来，研究人员不断改进原有的图像分割方法并把其它学科的一些新理论和新方法用于图像分割，提出了不少新的分割方法。图像分割后提取出的目标可以用于图像语义识别，图像搜索等等领域。
图像增强|增强图像中的有用信息，它可以是一个失真的过程，其目的是要改善图像的视觉效果，针对给定图像的应用场合。有目的地强调图像的整体或局部特性，将原来不清晰的图像变得清晰或强调某些感兴趣的特征，扩大图像中不同物体特征之间的差别，抑制不感兴趣的特征，使之改善图像质量、丰富信息量，加强图像判读和识别效果，满足某些特殊分析的需要。
图像平滑|图像平滑是指用于突出图像的宽大区域、低频成分、主干部分或抑制图像噪声和干扰高频成分，使图像亮度平缓渐变，减小突变梯度，改善图像质量的图像处理方法。
图像恢复|图像恢复是通过计算机处理，对质量下降的图像加以重建或恢复的处理过程。
图像搜索|图像搜索，是通过搜索图像文本或者视觉特征，为用户提供互联网上相关图形图像资料检索服务的专业搜索引擎系统，是搜索引擎的一种细分。通过输入与图片名称或内容相似的关键字来进行检索，另一种通过上传与搜索结果相似的图片或图片URL进行搜索。
图像跟踪|“图像跟踪”技术，是指通过某种方式（如图像识别、红外、超声波等）将摄像头中拍摄到的物体进行定位，狭义的“图像跟踪”技术就是我们日常所常谈到的，通过“图像识别”的方式来进行跟踪和拍摄。
工业机器人|工业机器人是面向工业领域的多关节机械手或多自由度的机器装置，它能自动执行工作，是靠自身动力和控制能力来实现各种功能的一种机器。它可以接受人类指挥，也可以按照预先编排的程序运行，现代的工业机器人还可以根据人工智能技术制定的原则纲领行动。
手眼系统|广义上讲，手眼系统就是一种机器人视觉系统；狭义地讲，摄像机与机器人的手部末端，构成手眼系统。[1] 
无人驾驶汽车|无人驾驶汽车是智能汽车的一种，也称为轮式移动机器人，主要依靠车内的以计算机系统为主的智能驾驶仪来实现无人驾驶的目标。据汤森路透知识产权与科技最新报告显示，2010年到 2015年间，与汽车无人驾驶技术相关的发明专利超过22,000件，并且在此过程中，部分企业已崭露头角，成为该领域的行业领导者。[1] 
测量|测量是按照某种规律，用数据来描述观察到的现象，即对事物作出量化描述。测量是对非量化实物的量化过程。在机械工程里面，测量指将被测量与具有计量单位的标准量在数值上进行比较，从而确定二者比值的实验认识过程。
深度学习|深度学习的概念源于人工神经网络的研究。含多隐层的多层感知器就是一种深度学习结构。深度学习通过组合低层特征形成更加抽象的高层表示属性类别或特征，以发现数据的分布式特征表示。[1] 深度学习的概念由Hinton等人于2006年提出。基于深度置信网络(DBN)提出非监督贪心逐层训练算法，为解决深层结构相关的优化难题带来希望，随后提出多层自动编码器深层结构。此外Lecun等人提出的卷积神经网络是第一个真正多层结构学习算法，它利用空间相对关系减少参数数目以提高训练性能。[1] 深度学习是机器学习中一种基于对数据进行表征学习的方法。观测值（例如一幅图像）可以使用多种方式来表示，如每个像素强度值的向量，或者更抽象地表示成一系列边、特定形状的区域等。而使用某些特定的表示方法更容易从实例中学习任务（例如，人脸识别或面部表情识别）。深度学习的好处是用非监督式或半监督式的特征学习和分层特征提取高效算法来替代手工获取特征。深度学习是机器学习研究中的一个新的领域，其动机在于建立、模拟人脑进行分析学习的神经网络，它模仿人脑的机制来解释数据，例如图像，声音和文本。[2] 同机器学习方法一样，深度机器学习方法也有监督学习与无监督学习之分．不同的学习框架下建立的学习模型很是不同．例如，卷积神经网络（Convolutional neural networks，简称CNNs）就是一种深度的监督学习下的机器学习模型，而深度置信网（Deep Belief Nets，简称DBNs）就是一种无监督学习下的机器学习模型。
看图说话|《看图说话》，撷取了生活中具有典型意义的画面，用绚丽的色彩、特色的构思、个性的想象，帮你打造一个全新的作文世界。
线条|汉语拼音词目：线条拼音：xiàn tiáo基本解释1. [line]∶绘画时描画的线粗线条2. [lines]∶人体或艺术品外形的曲线,多用于外在的形状、样子她的线条很美单点可以构成无数条射线；且一条射线上的点可以构成L=1/2(A^2-A）条线段。两点可以构成一条最短线段，即为直线段。
缩放|缩放的意思为：缩小和放大都自如。
美国有线电视新闻网|CNN是美国有线电视新闻网（Cable News Network）的英文缩写，由特纳广播公司（TBS）特德·特纳于1980年6月创办，通过卫星向有线电视网和卫星电视用户提供全天候的新闻节目，总部设在美国佐治亚州的亚特兰大。
运动|运动，一种涉及体力和技巧的由一套规则或习惯所约束的活动，通常具有竞争性。物布时空永不均产生了普遍运动，普遍的运动生灭着万事万物。没有不运动的物件，也没有能离开物件的运动。运动具守恒性，即运动既不能被创造又不能被消灭，其具体形式则是多样的并且能互相转化，在转化中运动总量不变。在几何中，刚性运动被描述为：平面到其自身的一个映射且使任意两点A,B的距离与其象A‘=M(A),B'=M(B)的距离相同。哲学上，运动的定义：物在时空中的线性迁移。
通道|在photoshop中，在不同的图像模式下，通道是不一样的。通道层中的像素颜色是由一组原色的亮度值组成的，通道实际上可以理解为是选择区域的映射。
K-means|K-means算法是硬聚类算法，是典型的基于原型的目标函数聚类方法的代表，它是数据点到原型的某种距离作为优化的目标函数，利用函数求极值的方法得到迭代运算的调整规则。K-means算法以欧式距离作为相似度测度，它是求对应某一初始聚类中心向量V最优分类，使得评价指标J最小。算法采用误差平方和准则函数作为聚类准则函数。
logistic回归|logistic回归又称logistic回归分析，是一种广义的线性回归分析模型，常用于数据挖掘，疾病自动诊断，经济预测等领域。例如，探讨引发疾病的危险因素，并根据危险因素预测疾病发生的概率等。以胃癌病情分析为例，选择两组人群，一组是胃癌组，一组是非胃癌组，两组人群必定具有不同的体征与生活方式等。因此因变量就为是否胃癌，值为“是”或“否”，自变量就可以包括很多了，如年龄、性别、饮食习惯、幽门螺杆菌感染等。自变量既可以是连续的，也可以是分类的。然后通过logistic回归分析，可以得到自变量的权重，从而可以大致了解到底哪些因素是胃癌的危险因素。同时根据该权值可以根据危险因素预测一个人患癌症的可能性。
主成分分析法|主成分分析也称主分量分析，旨在利用降维的思想，把多指标转化为少数几个综合指标（即主成分），其中每个主成分都能够反映原始变量的大部分信息，且所含信息互不重复。这种方法在引进多方面变量的同时将复杂因素归结为几个主成分，使问题简单化，同时得到的结果更加科学有效的数据信息。在实际问题研究中，为了全面、系统地分析问题，我们必须考虑众多影响因素。这些涉及的因素一般称为指标，在多元统计分析中也称为变量。因为每个变量都在不同程度上反映了所研究问题的某些信息，并且指标之间彼此有一定的相关性，因而所得的统计数据反映的信息在一定程度上有重叠。主要方法有特征值分解，SVD，NMF等。
交叉验证|交叉验证(Cross-validation)主要用于建模应用中，例如PCR 、PLS 回归建模中。在给定的建模样本中，拿出大部分样本进行建模型，留小部分样本用刚建立的模型进行预报，并求这小部分样本的预报误差，记录它们的平方加和。
先验|通常意义上理解，同“经验”相对，意为先于经验的，但为构成经验所不可或缺的。但此概念涉及对近代西方哲学基本问题的探讨，在不同语境，词义有微妙的区别。
决策树|决策树(Decision Tree）是在已知各种情况发生概率的基础上，通过构成决策树来求取净现值的期望值大于等于零的概率，评价项目风险，判断其可行性的决策分析方法，是直观运用概率分析的一种图解法。由于这种决策分支画成图形很像一棵树的枝干，故称决策树。在机器学习中，决策树是一个预测模型，他代表的是对象属性与对象值之间的一种映射关系。Entropy = 系统的凌乱程度，使用算法ID3, C4.5和C5.0生成树算法使用熵。这一度量是基于信息学理论中熵的概念。决策树是一种树形结构，其中每个内部节点表示一个属性上的测试，每个分支代表一个测试输出，每个叶节点代表一种类别。分类树（决策树）是一种十分常用的分类方法。他是一种监管学习，所谓监管学习就是给定一堆样本，每个样本都有一组属性和一个类别，这些类别是事先确定的，那么通过学习得到一个分类器，这个分类器能够对新出现的对象给出正确的分类。这样的机器学习就被称之为监督学习。
判别模型|判别模型是一种对未观测数据y与已观测数据x之间关系进行建模的方法，直接对条件概率p(y|x;θ)建模。
半监督学习|半监督学习(Semi-Supervised Learning，SSL)是模式识别和机器学习领域研究的重点问题，是监督学习与无监督学习相结合的一种学习方法。半监督学习使用大量的未标记数据，以及同时使用标记数据，来进行模式识别工作。当使用半监督学习时，将会要求尽量少的人员来从事工作，同时，又能够带来比较高的准确性，因此，半监督学习目前正越来越受到人们的重视。[1] 
后验|
奇异值分解|奇异值分解（Singular Value Decomposition）是线性代数中一种重要的矩阵分解，是矩阵分析中正规矩阵酉对角化的推广。在信号处理、统计学等领域有重要应用。奇异值分解则是谱分析理论在任意矩阵上的推广。
归一化|归一化是一种简化计算的方式，即将有量纲的表达式，经过变换，化为无量纲的表达式，成为标量。 在多种计算中都经常用到这种方法。
感知器|感知器（Perceptor）是《变形金刚》中的人物，博派科学家之一（G1中变形为显微镜）。在《变形金刚之雷霆舰队》中，感知器是由巷战小组（钢丝、突击手、冲浪板）合体而成的组合金刚。感知器可以变形成显微镜跟战车，但他鲜少参与战斗，反而热中于研究，对知识有近乎无限的渴求，不断进行对地球环境与变形金刚间的互相影响。
损失函数|在统计学，统计决策理论和经济学中，损失函数是指一种将一个事件（在一个样本空间中的一个元素）映射到一个表达与其事件相关的经济成本或机会成本的实数上的一种函数。更通俗地说，在统计学中损失函数是一种衡量损失和错误（这种损失与“错误地”估计有关，如费用或者设备的损失）程度的函数。
支持向量机|支持向量机(Support Vector Machine，SVM)是Corinna Cortes和Vapnik等于1995年首先提出的，它在解决小样本、非线性及高维模式识别中表现出许多特有的优势，并能够推广应用到函数拟合等其他机器学习问题中。在机器学习中，支持向量机（SVM，还支持矢量网络）是与相关的学习算法有关的监督学习模型，可以分析数据，识别模式，用于分类和回归分析。
无监督学习|现实生活中常常会有这样的问题：缺乏足够的先验知识，因此难以人工标注类别或进行人工类别标注的成本太高。很自然地，我们希望计算机能代我们完成这些工作，或至少提供一些帮助。根据类别未知(没有被标记)的训练样本解决模式识别中的各种问题，称之为无监督学习。[1] 
最优化|最优化是应用数学的一个分支，主要指在一定条件限制下，选取某种研究方案使目标达到最优的一种方法。最优化问题在当今的军事、工程、管理等领域有着极其广泛的应用。
朴素贝叶斯|朴素贝叶斯法是基于贝叶斯定理与特征条件独立假设的分类方法[1] 。最为广泛的两种分类模型是决策树模型(Decision Tree Model)和朴素贝叶斯模型（Naive Bayesian Model，NBM）。和决策树模型相比，朴素贝叶斯分类器(Naive Bayes Classifier,或 NBC)发源于古典数学理论，有着坚实的数学基础，以及稳定的分类效率。同时，NBC模型所需估计的参数很少，对缺失数据不太敏感，算法也比较简单。理论上，NBC模型与其他分类方法相比具有最小的误差率。但是实际上并非总是如此，这是因为NBC模型假设属性之间相互独立，这个假设在实际应用中往往是不成立的，这给NBC模型的正确分类带来了一定影响。
核函数|支持向量机[1] 通过某非线性变换 φ( x) ，将输入空间映射到高维特征空间。特征空间的维数可能非常高。如果支持向量机的求解只用到内积运算，而在低维输入空间又存在某个函数 K(x, x′) ，它恰好等于在高维空间中这个内积，即K( x, x′) =<φ( x) ⋅φ( x′) > 。那么支持向量机就不用计算复杂的非线性变换，而由这个函数 K(x, x′) 直接得到非线性变换的内积，使大大简化了计算。这样的函数 K(x, x′) 称为核函数。核函数包括线性核函数、多项式核函数、高斯核函数等，其中高斯核函数最常用，可以将数据映射到无穷维，也叫做径向基函数（Radial Basis Function 简称 RBF），是某种沿径向对称的标量函数。 通常定义为空间中任一点x到某一中心xc之间欧氏距离的单调函数 , 可记作 k（||x-xc||）， 其作用往往是局部的 , 即当x远离xc时函数取值很小。
梯度下降|梯度下降法是一个最优化算法，通常也称为最速下降法。最速下降法是求解无约束优化问题最简单和最古老的方法之一，虽然现在已经不具有实用性，但是许多有效算法都是以它为基础进行改进和修正而得到的。最速下降法是用负梯度方向为搜索方向的，最速下降法越接近目标值，步长越小，前进越慢。可以用于求解非线性方程组
概率图模型|概率图模型是用图来表示变量概率依赖关系的理论，由图灵奖获得者Pearl开发出来。概率图模型理论分为概率图模型表示理论，概率图模型推理理论和概率图模型学习理论。[1] 
正则化|正则化(regularization)，是指在线性代数理论中，不适定问题通常是由一组线性代数方程定义的，而且这组方程组通常来源于有着很大的条件数的不适定反问题。大条件数意味着舍入误差或其它误差会严重地影响问题的结果。
测试集|在机器学习中，一般将样本分成独立的三部分训练集(train set)，验证集(validation set)和测试集(test set)。其中，测试集用来检验最终选择最优的模型的性能如何。[1] 
深度学习|深度学习的概念源于人工神经网络的研究。含多隐层的多层感知器就是一种深度学习结构。深度学习通过组合低层特征形成更加抽象的高层表示属性类别或特征，以发现数据的分布式特征表示。[1] 深度学习的概念由Hinton等人于2006年提出。基于深度置信网络(DBN)提出非监督贪心逐层训练算法，为解决深层结构相关的优化难题带来希望，随后提出多层自动编码器深层结构。此外Lecun等人提出的卷积神经网络是第一个真正多层结构学习算法，它利用空间相对关系减少参数数目以提高训练性能。[1] 深度学习是机器学习中一种基于对数据进行表征学习的方法。观测值（例如一幅图像）可以使用多种方式来表示，如每个像素强度值的向量，或者更抽象地表示成一系列边、特定形状的区域等。而使用某些特定的表示方法更容易从实例中学习任务（例如，人脸识别或面部表情识别）。深度学习的好处是用非监督式或半监督式的特征学习和分层特征提取高效算法来替代手工获取特征。深度学习是机器学习研究中的一个新的领域，其动机在于建立、模拟人脑进行分析学习的神经网络，它模仿人脑的机制来解释数据，例如图像，声音和文本。[2] 同机器学习方法一样，深度机器学习方法也有监督学习与无监督学习之分．不同的学习框架下建立的学习模型很是不同．例如，卷积神经网络（Convolutional neural networks，简称CNNs）就是一种深度的监督学习下的机器学习模型，而深度置信网（Deep Belief Nets，简称DBNs）就是一种无监督学习下的机器学习模型。
特征选择|特征选择( Feature Selection )也称特征子集选择( Feature Subset Selection , FSS )，或属性选择( Attribute Selection )。是指从已有的M个特征(Feature)中选择N个特征使得系统的特定指标最优化，是从原始特征中选择出一些最有效特征以降低数据集维度的过程,是提高学习算法性能的一个重要手段,也是模式识别中关键的数据预处理步骤。对于一个学习算法来说,好的学习样本是训练模型的关键。[1] 此外，需要区分特征选择与特征提取。特征提取 ( Feature extraction )是指利用已有的特征计算出一个抽象程度更高的特征集，也指计算得到某个特征的算法。特征选择过程一般包括产生过程，评价函数，停止准则，验证过程，这4个部分。
神经网络|神经网络可以指向两种，一个是生物神经网络，一个是人工神经网络。生物神经网络：一般指生物的大脑神经元，细胞，触点等组成的网络，用于产生生物的意识，帮助生物进行思考和行动。人工神经网络（Artificial Neural Networks，简写为ANNs）也简称为神经网络（NNs）或称作连接模型（Connection Model），它是一种模仿动物神经网络行为特征，进行分布式并行信息处理的算法数学模型。这种网络依靠系统的复杂程度，通过调整内部大量节点之间相互连接的关系，从而达到处理信息的目的。人工神经网络：是一种应用类似于大脑神经突触联接的结构进行信息处理的数学模型。在工程与学术界也常直接简称为“神经网络”或类神经网络。
稀疏编码|稀疏编码（Sparse Coding）是一种模拟哺乳动物视觉系统主视皮层V1区简单细胞感受野人工神经网络方法。该方法具有空间的局部性、方向性和频域的带通性，是一种自适应的图像统计方法。
聚类|将物理或抽象对象的集合分成由类似的对象组成的多个类的过程被称为聚类。由聚类所生成的簇是一组数据对象的集合，这些对象与同一个簇中的对象彼此相似，与其他簇中的对象相异。“物以类聚，人以群分”，在自然科学和社会科学中，存在着大量的分类问题。聚类分析又称群分析，它是研究（样品或指标）分类问题的一种统计分析方法。聚类分析起源于分类学，但是聚类不等于分类。聚类与分类的不同在于，聚类所要求划分的类是未知的。聚类分析内容非常丰富，有系统聚类法、有序样品聚类法、动态聚类法、模糊聚类法、图论聚类法、聚类预报法等。在数据挖掘中，聚类也是很重要的一个概念。
训练集|在机器学习中，一般将样本分成独立的三部分训练集(train set)，验证集(validation set)和测试集(test set)。其中，训练集用于建立模型。
贝叶斯分类器|贝叶斯分类器的分类原理是通过某对象的先验概率，利用贝叶斯公式计算出其后验概率，即该对象属于某一类的概率，选择具有最大后验概率的类作为该对象所属的类。
过拟合|过拟合是指为了得到一致假设而使假设变得过度严格。避免过拟合是分类器设计中的一个核心任务。通常采用增大数据量和测试样本集的方法对分类器性能进行评价。
降维|降维，通过单幅图像数据的高维化，将单幅图像转化为高维空间中的数据集合，对其进行非线性降维。寻求其高维数据流形本征结构的一维表示向量，将其作为图像数据的特征表达向量。
集成学习|集成学习是使用一系列学习器进行学习，并使用某种规则把各个学习结果进行整合从而获得比单个学习器更好的学习效果的一种机器学习方法。[1] 
马尔可夫链|马尔可夫链，因安德烈·马尔可夫（A.A.Markov，1856－1922）得名，是指数学中具有马尔可夫性质的离散事件随机过程。该过程中，在给定当前知识或信息的情况下，过去（即当前以前的历史状态）对于预测将来（即当前以后的未来状态）是无关的。[1] 在马尔可夫链的每一步，系统根据概率分布，可以从一个状态变到另一个状态，也可以保持当前状态。状态的改变叫做转移，与不同的状态改变相关的概率叫做转移概率。随机漫步就是马尔可夫链的例子。随机漫步中每一步的状态是在图形中的点，每一步可以移动到任何一个相邻的点，在这里移动到每一个点的概率都是相同的（无论之前漫步路径是如何的）。
验证集|在机器学习中，一般将样本分成独立的三部分训练集(train set)，验证集(validation set)和测试集(test set)。其中，测试集用来检验最终选择最优的模型的性能如何[1] 。
google pagerank|PageRank，网页排名，又称网页级别、Google左侧排名或佩奇排名，是一种由[1] 根据网页之间相互的超链接计算的技术，而作为网页排名的要素之一，以Google公司创办人拉里·佩奇（Larry Page）之姓来命名。Google用它来体现网页的相关性和重要性，在搜索引擎优化操作中是经常被用来评估网页优化的成效因素之一。Google的创始人拉里·佩奇和谢尔盖·布林于1998年在斯坦福大学发明了这项技术。PageRank通过网络浩瀚的超链接关系来确定一个页面的等级。Google把从A页面到B页面的链接解释为A页面给B页面投票，Google根据投票来源（甚至来源的来源，即链接到A页面的页面）和投票目标的等级来决定新的等级。简单的说，一个高等级的页面可以使其他低等级页面的等级提升。
Google|谷歌公司（Google Inc.）成立于1998年9月4日，由拉里·佩奇和谢尔盖·布林共同创建，被公认为全球最大的搜索引擎。[1] 谷歌是一家位于美国的跨国科技企业，业务包括互联网搜索、云计算、广告技术等，同时开发并提供大量基于互联网的产品与服务，其主要利润来自于AdWords等广告服务。[2] 1999年下半年，谷歌网站“Google”正式启用。[3] 2010年3月23日，宣布关闭在中国大陆市场搜索服务。2015年8月10日，宣布对企业架构进行调整，并创办了一家名为Alphabet的“伞形公司”（Umbrella Company），成为Alphabet旗下子公司。2015年，在2015年度“世界品牌500强”排行中重返榜首，苹果和亚马逊分别位居第二和第三名。2016年6月8日，《2016年BrandZ全球最具价值品牌百强榜》公布，以2291.98亿美元的品牌价值重新超越苹果成为百强第一。[4]   2017年2月，Brand Finance发布2017年度全球500强品牌榜单，排名第一。[5] 2017年6月，《2017年BrandZ最具价值全球品牌100强》公布，谷歌公司名列第一位。[6] 
倒排索引|倒排索引源于实际应用中需要根据属性的值来查找记录。这种索引表中的每一项都包括一个属性值和具有该属性值的各记录的地址。由于不是由记录来确定属性值，而是由属性值来确定记录的位置，因而称为倒排索引(inverted index)。带有倒排索引的文件我们称为倒排索引文件，简称倒排文件(inverted file)。
元搜索引擎|搜索引擎分为全文搜索引擎、目录索引、元搜索引擎，元搜索引擎就是通过一个统一的用户界面帮助用户在多个搜索引擎中选择和利用合适的（甚至是同时利用若干个）搜索引擎来实现检索操作，是对分布于网络的多种检索工具的全局控制机制。
全文检索|全文数据库是全文检索系统的主要构成部分。所谓全文数据库是将一个完整的信息源的全部内容转化为计算机可以识别、处理的信息单元而形成的数据集合。全文数据库不仅存储了信息，而且还有对全文数据进行词、字、段落等更深层次的编辑、加工的功能，而且所有全文数据库无一不是海量信息数据库。
关键词|关键词源于英文“keywords”，特指单个媒体在制作使用索引时，所用到的词汇。是图书馆学中的词汇。关键词搜索是网络搜索索引主要方法之一，就是访问者希望了解的产品、服务和公司等的具体名称用语。
内链|内链，顾名思义就是在同一网站域名下的内容页面之间的互相链接（自己网站的内容链接到自己网站的内部页面，也称之为站内链接）。合理的网站内链接构造，能提高搜索引擎的收录与网站权重。相对外部链接，内部链接也很重要。
匹配|匹配，一般指配合或搭配，也指结婚。“匹配”一词在不同的领域有着不同的意思，它既是数学语言，又是计算机方面的术语，其含义复杂多变。
响应时间|响应时间是一个计算机，显示器成像等多个领域的概念，在网络上，指从空载到负载发生一个步进值的变化时，传感器的响应时间。通常定义为测试量变化一个步进值后，传感器达到最终数值90%所需要的时间。网络对整体响应时间的影响是通过不同机制完成的。在图像领域的液晶显示器响应时间，是液晶显示器各像素点对输入信号反应的速度，即像素由暗转亮或由亮转暗所需要的时间（其原理是在液晶分子内施加电压，使液晶分子扭转与回复）。常说的25ms、16ms就是指的这个反应时间，反应时间越短则使用者在看动态画面时越不会有尾影拖曳的感觉。一般将反应时间分为两个部分：上升时间(Rise time)和下降时间(Fall time)，而表示时以两者之和为准。
图像搜索|图像搜索，是通过搜索图像文本或者视觉特征，为用户提供互联网上相关图形图像资料检索服务的专业搜索引擎系统，是搜索引擎的一种细分。通过输入与图片名称或内容相似的关键字来进行检索，另一种通过上传与搜索结果相似的图片或图片URL进行搜索。
垂直搜索引擎|垂直搜索引擎是针对某一个行业的专业搜索引擎，是搜索引擎的细分和延伸，是对网页库中的某类专门的信息进行一次整合，定向分字段抽取出需要的数据进行处理后再以某种形式返回给用户。垂直搜索是相对通用搜索引擎的信息量大、查询不准确、深度不够等提出来的新的搜索引擎服务模式，通过针对某一特定领域、某一特定人群或某一特定需求提供的有一定价值的信息和相关服务。其特点就是“专、精、深”，且具有行业色彩，相比较通用搜索引擎的海量信息无序化，垂直搜索引擎则显得更加专注、具体和深入。
域名权重|域名权重(Domain Authority)指的是一个域名在搜索引擎上排名的综合实力。域名权重是很多因素的总和，包括域名种类、历史、内容原创性、链接关系等。
外链|外链就是指在别的网站导入自己网站的链接。导入链接对于网站优化来说是非常重要的一个过程。导入链接的质量（即导入链接所在页面的权重）间接影响了我们的网站在搜索引擎中的权重。外链是互联网的血液，是链接的一种。没有链接的话，信息就是孤立的，结果就是我们什么都看不到。一个网站是很难做到面面俱到的，因此需要链接到别的网站，将其他网站所能补充的信息吸收过来，连接外链不在于数量，而是在于链接外链的质量。外链的效果不只是为了提高网站的权重，也不仅仅是为了提高某个关键词的排名。一个高质量的外部链接是可以给网站带来很好的流量。
必应|微软必应（英文名：Bing）是微软公司于2009年5月28日推出，用以取代Live Search的全新搜索引擎服务。为符合中国用户使用习惯，Bing中文品牌名为“必应”。作为全球领先的搜索引擎之一，[1] 截至2013年5月，必应已成为北美地区第二大搜索引擎，如加上为雅虎提供的搜索技术支持，必应已占据29.3%的市场份额。2013年10月，微软在中国启用全新明黄色必应搜索标志并去除Beta标识，这使必应成为继Windows、Office和Xbox后的微软品牌第四个重要产品线，也标志着必应已不仅仅是一个搜索引擎，更将深度融入微软几乎所有的服务与产品中。在Windows Phone系统中，微软也深度整合了必应搜索，通过触摸搜索键引出，相比其他搜索引擎，界面也更加美观，整合信息也更加全面。[2] 2017年3月，微软人工智能（小冰）和必应搜索（大冰）整合开始，微软大小冰“合体” 。
文档|文档是软件开发使用和维护中的必备资料。软件文档或者源代码文档是指与软件系统及其软件工程过程有关联的文本实体。文档的类型包括软件需求文档，设计文档，测试文档，用户手册等。其中的需求文档，设计文档和测试文档一般是在软件开发过程中由开发者写就的，而用户手册等非过程类文档是由专门的非技术类写作人员写就的。文档能提高软件开发的效率，保证软件的质量，而且在软件的使用过程中有指导、帮助、解惑的作用，尤其在维护工作中，文档是不可或缺的资料。
权重|权重是一个相对的概念，针对某一指标而言。某一指标的权重是指该指标在整体评价中的相对重要程度。权重是要从若干评价指标中分出轻重来，一组评价指标体系相对应的权重组成了权重体系。
查全率|查全率(Recall Ratio)是指从数据库内检出的相关的信息量与总量的比率。查全率绝对值很难计算，只能根据数据库内容、数量来估算。查全率是衡量某一检索系统从文献集合中检出相关文献成功度的一项指标，即检出的相关文献与全部相关文献的百分比。[1] 
查准率|查准率（Precision）（精度）是衡量某一检索系统的信号噪声比的一种指标，即检出的相关文献与检出的全部文献的百分比。普遍表示为：查准率=（检索出的相关信息量/检索出的信息总量）x100%。
查询|查询，读音为chá xún，是用户通过设置某些查询条件，从表或其他查询中选取全部或者部分数据，以表的形式显示数据供用户浏览。[1] 
百度|百度（纳斯达克：BIDU），全球最大的中文搜索引擎、最大的中文网站。1999年底,身在美国硅谷的李彦宏看到了中国互联网及中文搜索引擎服务的巨大发展潜力，抱着技术改变世界的梦想，他毅然辞掉硅谷的高薪工作，携搜索引擎专利技术，于 2000年1月1日在中关村创建了百度公司。“百度”二字,来自于八百年前南宋词人辛弃疾的一句词：众里寻他千百度。这句话描述了词人对理想的执着追求。百度拥有数万名研发工程师，这是中国乃至全球最为优秀的技术团队。这支队伍掌握着世界上最为先进的搜索引擎技术，使百度成为中国掌握世界尖端科学核心技术的中国高科技企业，也使中国成为美国、俄罗斯、和韩国之外，全球仅有的4个拥有搜索引擎核心技术的国家之一。
目录式搜索引擎|以人工方式或半自动方式搜集信息，由编辑员查看信息之后，人工形成信息摘要，并将信息置于事先确定的分类框架中。信息大多面向网站，提供目录浏览服务和直接检索服务。对网站的要求较高，需要网站内容特别明确：在向目录搜索引擎提交网站时必须将网站放在一个最合适的目录（Directory）；目录搜索引擎要求各网站的有关信息必须手工填写。
相关性|相关性是指企业提供的会计信息应当与财务报表使用者的经济决策需要相关，有助于财务报表使用者对企业过去、现在或者未来的情况作出评价或预测。另外，相关性也指在网络搜索中，关键词被搜索引擎收录所依据的相关指标。相关性与关键词匹配性能很好地反应被搜索引擎收录。
站内搜索|只能在本站内才能搜索，跨网站就不能。
竞价排名|
网络爬虫|网络爬虫（又被称为网页蜘蛛，网络机器人，在FOAF社区中间，更经常的称为网页追逐者），是一种按照一定的规则，自动地抓取万维网信息的程序或者脚本。另外一些不常使用的名字还有蚂蚁、自动索引、模拟程序或者蠕虫。
过滤|是一大类单元操作的总称。[filter;filterate] 通过特殊装置将流体提纯净化的过程，过滤的方式很多，使用的物系也很广泛，固-液、固-气、大颗粒、小颗粒都很常见。过滤是在推动力或者其他外力作用下悬浮液（或含固体颗粒发热气体）中的液体（或气体）透过介质，固体颗粒及其他物质被过滤介质截留，从而使固体及其他物质与液体（或气体）分离的操作[1] 。
高级搜索|高级搜索，网页标题通常是对网页内容提纲挈领式的归纳。把查询内容范围限定在网页标题中，有时能获得良好的效果。使用的方式，是把查询内容中，特别关键的部分，用“intitle:”领起来。
个性化|个性化，顾名思义，就是非一般大众化的东西。在大众化的基础上增加独特、另类、拥有自己特质的需要，独具一格，别开生面的一种说法。打造一种与众不同的效果。有时也叫定制化，指为适应特定个体而裁剪服务或产品，有时与一组或一群个体绑定。有很多组织通过个性化提高客户满意度，提高线上销售转化、营销效果、品牌，改进网站指标，以及广告。个性化是社交媒体和推荐系统中的一个关键元素。
余弦相似度|余弦相似度，又称为余弦相似性，是通过计算两个向量的夹角余弦值来评估他们的相似度。余弦相似度将向量根据坐标值，绘制到向量空间中，如最常见的二维空间。
信息过滤|信息过滤有很多定义，Belkin和Croft的文章给出了这样的定义：信息过滤是用以描述一系列将信息传递给需要它的用户处理过程的总称。相当于传统的数据库来说，信息过滤系统是一个针对非结构化或半结构化的信息系统。信息过滤系统主要处理的是文本信息。信息过滤系统常常要处理巨大的数据量。
冷启动|冷启动，电脑的一种启动方式。就是切断电脑的电源，重新启动，一旦冷启动，内存的东西全部丢失，重新检测硬件，进入CMOS，再依启动操作系统。一般按机箱上POWER按钮启动。另一种也指冷启动问题是协同过滤推荐算法中被广泛关注的一个经典问题。也指一种作战方式。
准确度|指在一定实验条件下多次测定的平均值与真值相符合的程度，以误差来表示。它用来表示系统误差的大小。在实际工作中，通常用标准物质或标准方法进行对照试验，在无标准物质或标准方法时，常用加入被测定组分的纯物质进行回收试验来估计和确定准确度。
召回率|召回率(Recall Rate,也叫查全率)是检索出的相关文档数和文档库中所有的相关文档数的比率，衡量的是检索系统的查全率；精度是检索出的相关文档数与检索出的文档总数的比率，衡量的是检索系统的查准率。召回率(Recall)和精度(Precise)是广泛用于信息检索和统计学分类领域的两个度量值，用来评价结果的质量。
品味|品味，大概是指一个人的品质，趣味，情操，修养。品，有人品、品质、品德的意思，味是趣味、体味、回味。但品味从字面上还有另外一个最原始、最直接的解释。
多样性|广义的遗传多样性是指地球上生物所携带的各种遗传信息的总和。这些遗传信息储存在生物个体的基因之中。因此，遗传多样性也就是生物的遗传基因的多样性。任何一个物种或一个生物个体都保存着大量的遗传基因，因此，可被看作是一个基因库（Gene pool）。一个物种所包含的基因越丰富，它对环境的适应能力越强。基因的多样性是生命进化和物种分化的基础。
实时性|实时性，指时钟信号能够准确的定时，各处的时钟能够达到一致，在不同的场合需要达到ns级、μs级。实时性可以定义为:在规定时间内系统的反应能力.一般,有实时要求的应用有两个突出的特点:其中的活动时间性强,要求在一定的时刻和或一定的时间内自外部环境收集信息、再及时作出响应[1] 
属性|属性就是对于一个对象的抽象刻画[1] .一个具体事物，总是有许许多多的性质与关系，我们把一个事物的性质与关系，都叫做事物的属性。事物与属性是不可分的，事物都是有属性的事物，属性也都是事物的属性。一个事物与另一个事物的相同或相异，也就是一个事物的属性与另一事物的属性的相同或相异。由于事物属性的相同或相异，客观世界中就形成了许多不同的事物类。具有相同属性的事物就形成一类，具有不同属性的事物就分别地形成不同的类。苹果是一类事物，它是由许多具有相同属性的个别事物组成的。梨也是一类事物，它也是由许多具有相同属性的个别事物组成的。苹果和梨是两个不同的类。苹果这个类的共同属性是不同于梨这个类的共同属性的。
新颖性|依据我国《专利法》第22条第2款规定，新颖性，是指该发明或实用新型不属于现有技术；也没有任何单位或者个人就同样的发明或实用新型在申请日以前向专利局提出过申请，并记载在申请日以后公布的专利申请文件或者公告的专利文件中。申请专利的发明或者实用新型满足新颖性的标准，必须不同于现有技术，同时还不得出现抵触申请。
点击率|点击率是指网站页面上某一内容被点击的次数与被显示次数之比，即clicks/views，它是一个百分比。反映了网页上某一内容的受关注程度，经常用来衡量广告的吸引程度。
热门|《热门》是由腾讯视频、腾讯娱乐联合打造的寻找“MR.KEY”互联网综艺游戏节目，由何炅、黄子佼主持，于每周二在腾讯视频播出。[1] 这是一档需要发挥逻辑推理和胡搅蛮缠能力的游戏节目。节目邀请当下最新最热的影视剧明星，在主持人带领下与游戏天团共同完成寻找“MR.KEY”的任务。
物品|物品，汉语词语，读音为wù pǐn，是生产、办公、生活领域常用的一个概念，泛指各种东西或零星的物品，[1] 也指经济活动中涉及到实体流动的物质资料。
用户|用户，是指所有接受某一项产品服务的客体，不单指某一类人，泛指所有享受服务的客观事物。
用户画像|用户画像又称用户角色，作为一种勾画目标用户、联系用户诉求与设计方向的有效工具，用户画像在各领域得到了广泛的应用。
皮尔逊相关系数|在统计学中，皮尔逊积矩相关系数（英语：Pearson product-moment correlation coefficient，又称作 PPMCC或PCCs[1], 文章中常用r或Pearson's r表示）用于度量两个变量X和Y之间的相关（线性相关），其值介于-1与1之间。在自然科学领域中，该系数广泛用于度量两个变量之间的相关程度。它是由卡尔·皮尔逊从弗朗西斯·高尔顿在19世纪80年代提出的一个相似却又稍有不同的想法演变而来的。[2][3]这个相关系数也称作“皮尔森相关系数r”。
相似度|
矩阵分解|矩阵分解 (decomposition, factorization)是将矩阵拆解为数个矩阵的乘积，可分为三角分解、满秩分解、QR分解、Jordan分解和SVD（奇异值）分解等，常见的有三种：1)三角分解法 (Triangular Factorization)，2)QR 分解法 (QR Factorization)，3)奇异值分解法 (Singular Value Decomposition)。
稀疏性|稀疏性,是指大多数信道系数的能量较小,而几个能量较大的抽头分布相隔较远。
覆盖率|覆盖率是度量测试完整性的一个手段，是测试有效性的一个度量。通过已执行代码表示，用于可靠性、稳定性以及性能的评测。测试覆盖是对测试完全程度的评测。测试覆盖是由测试需求和测试用例的覆盖或已执行代码的覆盖表示的。建立在对测试结果的评估和对测试过程中确定的变更请求（缺陷）的分析的基础上。
评分|评分是汉语词汇，解释为评定分数。
负反馈|反馈又称回馈，是控制论的基本概念，指将系统的输出返回到输入端并以某种方式改变输入，进而影响系统功能的过程。反馈可分为负反馈和正反馈。前者使输出起到与输入相反的作用，使系统输出与系统目标的误差减小，系统趋于稳定；后者使输出起到与输入相似的作用，使系统偏差不断增大，使系统振荡，可以放大控制作用。对负反馈的研究是控制论的核心问题。另外有电流负反馈的理论。
长尾分布|长尾分布（long-tailed distributions）是重尾分布的一个子类型。
google pagerank|PageRank，网页排名，又称网页级别、Google左侧排名或佩奇排名，是一种由[1] 根据网页之间相互的超链接计算的技术，而作为网页排名的要素之一，以Google公司创办人拉里·佩奇（Larry Page）之姓来命名。Google用它来体现网页的相关性和重要性，在搜索引擎优化操作中是经常被用来评估网页优化的成效因素之一。Google的创始人拉里·佩奇和谢尔盖·布林于1998年在斯坦福大学发明了这项技术。PageRank通过网络浩瀚的超链接关系来确定一个页面的等级。Google把从A页面到B页面的链接解释为A页面给B页面投票，Google根据投票来源（甚至来源的来源，即链接到A页面的页面）和投票目标的等级来决定新的等级。简单的说，一个高等级的页面可以使其他低等级页面的等级提升。
Map|Map（Modified Atmosphere Packaging）是一种应用于气调保鲜技术的名词。该名词常使用在食品包装领域。可能可以在食品包装袋中看到。
Web搜索|《Web搜索》是2009年高等教育出版社出版的图书。内容包括导论、文本检索、图像检索、音频检索、信息过滤、信息推荐以及发展前沿。对Web搜索的基本概念进行定义，阐述其科学价值和研究状况，根据Web搜索所涵盖的检索、过滤以及推荐技术，论述其中的核心问题、基本概念和基本方法，并介绍Web搜索若干新的研究方向。
XML检索|随着Internet上信息量的与日俱增，传统的基于HTML的信息检索已经无法满足人们不断变化的信息需求。
伪相关反馈|伪相关反馈是一种自动局部分析方法。
信息标引|信息标引是指在分析文献内容的基础上，用某种检索语言把文献主题以及其他有意义的特征标识出来作为文献存储与检索依据的一种文献处理过程。
信息采集|信息采集是指未出版的生产在信息资源方面做准备的工作，包括对信息的收集和处理。它是选题策划的直接基础和重要依据。信息采集工作最后一个步骤的延伸，成选题策划的开端。
倒排索引|倒排索引源于实际应用中需要根据属性的值来查找记录。这种索引表中的每一项都包括一个属性值和具有该属性值的各记录的地址。由于不是由记录来确定属性值，而是由属性值来确定记录的位置，因而称为倒排索引(inverted index)。带有倒排索引的文件我们称为倒排索引文件，简称倒排文件(inverted file)。
全文检索|全文数据库是全文检索系统的主要构成部分。所谓全文数据库是将一个完整的信息源的全部内容转化为计算机可以识别、处理的信息单元而形成的数据集合。全文数据库不仅存储了信息，而且还有对全文数据进行词、字、段落等更深层次的编辑、加工的功能，而且所有全文数据库无一不是海量信息数据库。
向量空间模型|向量空间模型（VSM：Vector Space Model）由Salton等人于20世纪70年代提出，并成功地应用于著名的SMART文本检索系统。把对文本内容的处理简化为向量空间中的向量运算，并且它以空间上的相似度表达语义的相似度，直观易懂。
图像检索|从20世纪70年代开始，有关图像检索的研究就已开始，当时主要是基于文本的图像检索技术（Text-based Image Retrieval，简称TBIR），利用文本描述的方式描述图像的特征，如绘画作品的作者、年代、流派、尺寸等。到90年代以后，出现了对图像的内容语义，如图像的颜色、纹理、布局等进行分析和检索的图像检索技术，即基于内容的图像检索（Content-based Image Retrieval，简称CBIR）技术。CBIR属于基于内容检索（Content-based Retrieval，简称CBR）的一种，CBR中还包括对动态视频、音频等其它形式多媒体信息的检索技术。
多媒体分类分检索|在基于内容的图像（视频）检索中，颜色，纹理，形状和运动等视觉特征被提取出来表征图像（视频）内容所蕴涵的语义，从而实现图像（视频）数据的查询与管理。即称为多媒体分类分检索
布尔模型|布尔（Boolean）模型是基于集合论和布尔代数的一种简单检索模型。它的特点是查找那些于某个查询词返回为“真”的文档。
排序|排序是计算机内经常进行的一种操作，其目的是将一组“无序”的记录序列调整为“有序”的记录序列。分内部排序和外部排序。若整个排序过程不需要访问外存便能完成，则称此类排序问题为内部排序。反之，若参加排序的记录数量很大，整个序列的排序过程不可能在内存中完成，则称此类排序问题为外部排序。内部排序的过程是一个逐步扩大记录的有序序列长度的过程。
效率|效率（efficiency）是指有用功率对驱动功率的比值，同时也引申出了多种含义。效率也分为很多种，比如机械效率（mechanical efficiency）、热效率（thermal efficiency ）等。效率与做功的快慢没有直接关系。效率是指在给定投入和技术等条件下、最有效地使用资源以满足设定的愿望和需要的评价方式。
文档|文档是软件开发使用和维护中的必备资料。软件文档或者源代码文档是指与软件系统及其软件工程过程有关联的文本实体。文档的类型包括软件需求文档，设计文档，测试文档，用户手册等。其中的需求文档，设计文档和测试文档一般是在软件开发过程中由开发者写就的，而用户手册等非过程类文档是由专门的非技术类写作人员写就的。文档能提高软件开发的效率，保证软件的质量，而且在软件的使用过程中有指导、帮助、解惑的作用，尤其在维护工作中，文档是不可或缺的资料。
文档集合|文档集合（Document Collection）的概念比文档更高一层，一个文档集合把一类文档聚集在一起，方便用户操作，集合级别上的查询、修改操作都会反映到集合内的每个文档内中。
查询|查询，读音为chá xún，是用户通过设置某些查询条件，从表或其他查询中选取全部或者部分数据，以表的形式显示数据供用户浏览。[1] 
相关反馈|
相关度|相关度（Relevancy）是指两个事物间存在相互联系的百分比。相关度理论是一个相当复杂的理论， 由Mizzaro提出了一个较成功的理论框架， 它主要有个维度信息源信息需求的表示时间构建。考虑这个主要因素就可以基本准确地描述出两个事物的相关度。相关度是带有主观色彩的概念， 不同的人对同一词所给出的相关度都会不同， 因此在生物字典中所存储的词或词的相关度都是由领域专家给出， 其取值在到之间， 或者抽取具有代表性的查询词汇来组成生物字典。文档或由几个或一些词、词组就可以完全表示其中的内容， 那么这些词与该领域的相关度就成为决定文档或与领域相关的关键因素。
词项|词项 英文（原文）term and concept，指的是 逻辑分析的基本单元。在传统逻辑里，词项就是直言命题的主项和谓项；能作为命题的主项和谓项的，就叫做概念。
跨语言信息检索|跨语言检索(Cross Language Information Retrieval, CLIR)即可用一种提问语言检索出用另一种语言书写的信息，也就是一种跨越语言界限进行检索的问题。跨语言信息检索研究涉及了语言学、情报学、计算机科学等多门学科知识，是一个综合性强、富有挑战性的研究领域。跨语言检索技术的实现应用了信息检索、文字处理、和机器翻译等技术，如文字切分技术、词汇翻译、词频技术、索引技术等。
问答系统|问答系统(Question Answering System, QA)是信息检索系统的一种高级形式，它能用准确、简洁的自然语言回答用户用自然语言提出的问题。其研究兴起的主要原因是人们对快速、准确地获取信息的需求。问答系统是目前人工智能和自然语言处理领域中一个倍受关注并具有广泛发展前景的研究方向。
Freebase|Freebase是个类似wikipedia的创作共享类网站，所有内容都由用户添加，采用创意共用许可证，可以自由引用。两者之间最大的不同在于，Freebase中的条目都采用结构化数据的形式，而wikipedia不是。
rdf|资源描述框架（Resource Description Framework），一种用于描述Web资源的标记语言。RDF是一个处理元数据的XML（标准通用标记语言的子集）应用，所谓元数据，就是“描述数据的数据”或者“描述信息的信息”。也许这样解释元数据有些令人难以理解，举个简单的例子，书的内容是书的数据，而作者的名字、出版社的地址或版权信息就是书的元数据。数据和元数据的划分不是绝对的，有些数据既可以作为数据处理，也可以作为元数据处理，例如可以将作者的名字作为数据而不是元数据处理。
三元组|三元组是指形如((x,y),z)的集合（这就是说，三元组是这样的偶，其第一个射影亦是一个偶）,常简记为(x,y,z)。三元组是：计算机专业的一门公共基础课程——数据结构里的概念。主要是用来存储稀疏矩阵的一种压缩方式，也叫三元组表。假设以顺序存储结构来表示三元组表（triple table），则得到稀疏矩阵的一种压缩存储方式，即三元组顺序表，简称三元组表。
众包|众包指的是一个公司或机构把过去由员工执行的工作任务，以自由自愿的形式外包给非特定的（而且通常是大型的）大众网络的做法。（就是通过网络做产品的开发需求调研，以用户的真实使用感受为出发点）。众包的任务通常是由个人来承担，但如果涉及到需要多人协作完成的任务，也有可能以依靠开源的个体生产的形式出现。在美国《连线》杂志2006年的6月刊上，该杂志的记者Jeff Howe首次推出了众包的概念，不过，从提出时间看美国人提出的众包比2005年在中国诞生的威客晚了一年。
关系|关系是指人与人之间，人与事物之间，事物与事物之间的相互联系。市场营销中的关系是指精明的市场营销者为了促使企业交易成功而与其顾客、分销商、经销商、供应商等建立起长期的互利互信关系。它促使市场营销者以公平的价格，优质的产品，良好的服务与对方交易，同时，双方的成员之间还需加强经济，技术及社会等各方面的联系与交易。人际关系是人与人之间在活动过程中直接的心理上的关系或心理上的距离。人际关系反映了个人或群体寻求满足其社会需要的心理状态，因此，人际关系的变化与发展决定于双方社会需要满足的程度。人在社会中不是孤立的，人的存在是各种关系发生作用的结果，人正是通过和别人发生作用而发展自己，实现自己的价值。关系可分为正式关系和非正式关系，非正式关系较正式关系更为古老和普遍。现代管理理论的奠基人巴纳德指出，即使在正式的组织中，个体仍然是社会人。自20世纪30年代以来，在包括政治学、社会学、经济学及管理学等众多学科中，关系的非正式性受到了越来越多的重视。关系的内涵在中西方有所不同，西方特意用Guanxi（relationship）一词来描述中国式的关系。[1] 
关联|关联，指互相贯连。语出《尉缭子·将理》：“如此关联良民，皆囚之情也。”
可视化|可视化（Visualization）是利用计算机图形学和图像处理技术，将数据转换成图形或图像在屏幕上显示出来，再进行交互处理的理论、方法和技术。
命名实体|命名实体(named entity)所谓的命名实体就是人名、机构名、地名以及其他所有以名称为标识的实体。更广泛的实体还包括数字、日期、货币、地址等等。
图数据库|世界上的大部分领域实际上都可以建模成图，而软件开发人员或是数据库管理人员却在辛辛苦苦地将这些图转化成关系型数据库中的表。想象一下，假如你再也不用去做这样的转化，假如数据库的迁移可以变得轻松简单，你愿意去接受一个全新的数据库吗？图数据库就是这样一个完全不同于关系型数据库的新型数据库，它处理的是大规模的数据和不断变化的需求。 《图数据库》系统地介绍了图数据库的历史由来、建模方法、工作原理和一些真实的用户用例，详细地说明了图数据解决的是什么样的问题，并以Neo4j数据库和Cypher查询语言为例，阐述了图数据库的建模方法和领域用例，最后还介绍了图数据库的工作原理以及一些实用的图论算法。本书的三位作者均为Neo4j Technology公司的技术高手，他们对图数据库及其解决方案有丰富的经验，其中一位甚至还是Neo4j图数据库的联合创始人。[1] 
属性|属性就是对于一个对象的抽象刻画[1] .一个具体事物，总是有许许多多的性质与关系，我们把一个事物的性质与关系，都叫做事物的属性。事物与属性是不可分的，事物都是有属性的事物，属性也都是事物的属性。一个事物与另一个事物的相同或相异，也就是一个事物的属性与另一事物的属性的相同或相异。由于事物属性的相同或相异，客观世界中就形成了许多不同的事物类。具有相同属性的事物就形成一类，具有不同属性的事物就分别地形成不同的类。苹果是一类事物，它是由许多具有相同属性的个别事物组成的。梨也是一类事物，它也是由许多具有相同属性的个别事物组成的。苹果和梨是两个不同的类。苹果这个类的共同属性是不同于梨这个类的共同属性的。
有向图|一个有向图D是指一个有序三元组(V(D)，A(D)，ψD)，其中ψD)为关联函数，它使A(D)中的每一个元素(称为有向边或弧)对应于V(D)中的一个有序元素(称为顶点或点)对．[1] 
本体|本体指事物的本身；引申为根本的；哲学名词。语出《北史·魏彭城王勰传》：“帝曰：‘虽琱琢一字，犹是玉之本体。’”“本体”是‘本’和‘体’两个独立的汉字组成的汉语复合词。
查询|查询，读音为chá xún，是用户通过设置某些查询条件，从表或其他查询中选取全部或者部分数据，以表的形式显示数据供用户浏览。[1] 
百科|百科（日语：百科(ひゃっか)；韩语：백과；）英语：Encyclopedia；法语：Encyclopédie；德语：Enzyklopädie；俄语： энциклопедия；葡萄牙语：enciclopédia）指天文、地理、自然、人文、宗教、信仰、文学等全部学科的知识的总称。
知识库|知识库有两种含义：一种是指专家系统设计所应用的规则集合，包含规则所联系的事实及数据，它们的全体构成知识库。这种知识库是与具体的专家系统有关，不存在知识库的共享问题；另一种是指具有咨询性质的知识库，这种知识库是共享的，不是一家所独有的。从今后的发展来看，巨型知识库将会出现，达依赖于硬件及软件条件的发展。下一代计算机所应考虑的重要问题之一是知识库的设计，以知识库为背景的知识库机及共管理系统构设计。[1] 
知识挖掘|知识挖掘源于全球范围内数据库中存储的数据量急剧增加，人们的需求已经不只是简单的查询和维护，而是希望能够对这些数据进行较高层次的处理和分析以得到关于数据总体特征和对发展趋势的预测。知识挖掘最新的描述性定义是由UsamaM.Fayyyad等给出的：知识挖掘是从数据集中识别出有效的、新颖的、潜在有用的，以及最终可理解的模式的非平凡过程。
知识表示|知识表示（knowledge representation）是指把知识客体中的知识因子与知识关联起来，便于人们识别和理解知识。知识表示是知识组织的前提和基础，任何知识组织方法都是要建立在知识表示的基础上。知识表示有主观知识表示和客观知识表示两种。
语义|数据的含义就是语义(semantic)。简单的说，数据就是符号。数据本身没有任何意义，只有被赋予含义的数据才能够被使用，这时候数据就转化为了信息，而数据的含义就是语义。语义可以简单地看作是数据所对应的现实世界中的事物所代表的概念的含义，以及这些含义之间的关系，是数据在某个领域上的解释和逻辑表示。
语义网|语义网是对未来网络的一个设想，现在与Web 3.0这一概念结合在一起，作为3.0网络时代的特征之一。简单地说，语义网是一种智能网络，它不但能够理解词语和概念，而且还能够理解它们之间的逻辑关系，可以使交流变得更有效率和价值。语义网，它的核心是：通过给万维网上的文档 （如：HTML文档、XML文档）添加能够被计算机所理解的语义“元数据”（外语：Meta data），从而使整个互联网成为一个通用的信息交换媒介。[1] 
n元语法|
tf-idf|TF-IDF（term frequency–inverse document frequency）是一种用于信息检索与数据挖掘的常用加权技术。TF意思是词频(Term Frequency)，IDF意思是逆向文件频率(Inverse Document Frequency)。
Token|在计算机身份认证中是令牌（临时）的意思，在词法分析中是标记的意思。
信息抽取|信息抽取 （Information Extraction: IE）是把文本里包含的信息进行结构化处理，变成表格一样的组织形式。输入信息抽取系统的是原始文本，输出的是固定格式的信息点。信息点从各种各样的文档中被抽取出来，然后以统一的形式集成在一起。这就是信息抽取的主要任务。信息以统一的形式集成在一起的好处是方便检查和比较。 信息抽取技术并不试图全面理解整篇文档，只是对文档中包含相关信息的部分进行分析。至于哪些信息是相关的，那将由系统设计时定下的领域范围而定。
信息检索|信息检索（Information Retrieval）是用户进行信息查询和获取的主要方式，是查找信息的方法和手段。狭义的信息检索仅指信息查询（Information Search）。即用户根据需要，采用一定的方法，借助检索工具，从信息集合中找出所需要信息的查找过程。广义的信息检索是信息按一定的方式进行加工、整理、组织部存储起来，再根据信息用户特定的需要将相关信息准确的查找出来的过程。又称信息的存储于检索。一般情况下，信息检索指的就是广义的信息检索。
分词|分词就是具有动词及形容词二者特征的词，尤指以-ing或-ed,-d,-t,-en或-n结尾的英语动词性形容词，具有形容词功能，同时又表现各种动词性特点，如时态、语态、带状语性修饰语的性能及带宾词的性能。分词分为现在分词和过去分词两种，是一种非谓语动词形式。现在分词和过去分词主要差别在于：现在分词表示“主动和进行”，过去分词表示“被动和完成”（不及物动词的过去分词不表示被动，只表示完成）。分词可以有自己的状语、宾语或逻辑主语等。
匹配|匹配，一般指配合或搭配，也指结婚。“匹配”一词在不同的领域有着不同的意思，它既是数学语言，又是计算机方面的术语，其含义复杂多变。
单词联想|
句法分析|句法分析(Parsing)就是指对句子中的词语语法功能进行分析，比如“我来晚了”，这里“我”是主语，“来”是谓语，“晚了”是补语。
命名实体识别|命名实体识别（Named Entity Recognition，简称NER），又称作“专名识别”，是指识别文本中具有特定意义的实体，主要包括人名、地名、机构名、专有名词等。
指代消解|指代消解是自然语言处理的重要内容，在信息抽取时，就用到了指代消解技术。
文本分类|文本分类用电脑对文本集(或其他实体或物件)按照一定的分类体系或标准进行自动分类标记。属于一种基于分类体系的自动分类，是朴素贝叶斯分类方法。
文本聚类|文本聚类（Text clustering）文档聚类主要是依据著名的聚类假设：同类的文档相似度较大，而不同类的文档相似度较小。作为一种无监督的机器学习方法，聚类由于不需要训练过程，以及不需要预先对文档手工标注类别，因此具有一定的灵活性和较高的自动化处理能力，已经成为对文本信息进行有效地组织、摘要和导航的重要手段，为越来越多的研究人员所关注。
机器翻译|机器翻译，又称为自动翻译，是利用计算机将一种自然语言(源语言)转换为另一种自然语言(目标语言)的过程。它是计算语言学的一个分支，是人工智能的终极目标之一，具有重要的科学研究价值。同时，机器翻译又具有重要的实用价值。随着经济全球化及互联网的飞速发展，机器翻译技术在促进政治、经济、文化交流等方面起到越来越重要的作用。
条件随机场|条件随机场跟隐式马可夫模型常被一起提及，条件随机场对于输入和输出的机率分布，没有如隐式马可夫模型那般强烈的假设存在。
统计|统计一词起源于国情调查，最早意为国情学。一般来说，统计包括三个含义：统计工作、统计资料和统计科学。统计工作、统计资料、统计科学三者之间的关系是：统计工作的成果是统计资料，统计资料和统计科学的基础是统计工作，统计科学既是统计工作经验的理论概括，又是指导统计工作的原理、原则和方法。原始的统计工作即人们收集数据的原始形态已经有几千年的历史，而它作为一门科学，是从17世纪开始。英语中统计学家和统计员是同一个单词，但统计学并不是直接产生于统计工作的经验总结。每一门科学都有其建立、发展和客观条件，统计科学则是统计工作经验、社会经济理论、计量经济方法融合、提炼、发展而来的一种边缘性学科。[1] 
规则|规则，是运行、运作规律所遵循的法则。规则，一般指由群众共同制定、公认或由代表人统一制定并通过的，由群体里的所有成员一起遵守的条例和章程。它存在三种形式：明规则、潜规则、元规则，无论何种规则只要违背善恶的道德必须严惩不贷以维护世间和谐；明规则是有明文规定的规则，存在需要不断完善的局限性；潜规则是无明文规定的规则，约定俗成无局限性，可弥补明规则不足之处；元规则是一种以暴力竞争解决问题的规则，善恶参半，非道德之理的文明之道。
词典|词典又作“辞典“，是收集词汇按某种顺序排列并加以解释供人检查参考的工具书。有语文词典、专科词典和综合性词典之分。世界上现存最古老的词典是公元前7世纪亚述帝国时编的苏美尔-阿卡德语双语难词表。中国最早的词典是中国西汉初编纂的《尔雅》。
词序|词序是词在词组或句子里的先后次序。在汉语里，词序是一种主要语法手段。词序的变动能使整个句子或词组具有不同的意义。
词频|TF-IDF（term frequency–inverse document frequency）词频--反转文件频率，是一种用于情报检索与文本挖掘的常用加权技术，用以评估一个词对于一个文件或者一个语料库中的一个领域文件集的重要程度。
语义分析|语义分析是编译过程的一个逻辑阶段， 语义分析的任务是对结构上正确的源程序进行上下文有关性质的审查，进行类型审查。语义分析是审查源程序有无语义错误，为代码生成阶段收集类型信息。比如语义分析的一个工作是进行类型审查，审查每个算符是否具有语言规范允许的运算对象，当不符合语言规范时，编译程序应报告错误。如有的编译程序要对实数用作数组下标的情况报告错误。又比如某些某些程序规定运算对象可被强制，那么当二目运算施于一整型和一实型对象时，编译程序应将整型转换为实型而不能认为是源程序的错误。语义分析的地位:编译程序最实质性的工作；第一次对源程序的语义作出解释，引起源程序质的变化。[1] 
语料库|关于语料库的三点基本认识：语料库中存放的是在语言的实际使用中真实出现过的语言材料；语料库是以电子计算机为载体承载语言知识的基础资源；真实语料需要经过加工（分析和处理），才能成为有用的资源。
语言环境|语言环境即指说话时，人所处的状况和状态。语言环境有多种：一般地说，有自然语言环境、局部语言环境和自我营造的人工语言环境。自然语言环境是指以该语言为母语的生活环境。局部的语言环境是指学习者部分时间生活或学习于该门语言环境中。而人工语言环境主要指学习者在头脑中用该门语言复述、描述、记忆或营造某些的场景。
语音合成|语音合成是通过机械的、电子的方法产生人造语音的技术。TTS技术（又称文语转换技术）隶属于语音合成，它是将计算机自己产生的、或外部输入的文字信息转变为可以听得懂的、流利的汉语口语输出的技术。采用世界领先的语音合成技术，研发出来的“语音合成助手”软件可以完美的完成语音合成工作。
语音识别|语音识别是一门交叉学科。近二十年来，语音识别技术取得显著进步，开始从实验室走向市场。人们预计，未来10年内，语音识别技术将进入工业、家电、通信、汽车电子、医疗、家庭服务、消费电子产品等各个领域。 语音识别听写机在一些领域的应用被美国新闻界评为1997年计算机发展十件大事之一。很多专家都认为语音识别技术是2000年至2010年间信息技术领域十大重要的科技发展技术之一。 语音识别技术所涉及的领域包括：信号处理、模式识别、概率论和信息论、发声机理和听觉机理、人工智能等等。
问答系统|问答系统(Question Answering System, QA)是信息检索系统的一种高级形式，它能用准确、简洁的自然语言回答用户用自然语言提出的问题。其研究兴起的主要原因是人们对快速、准确地获取信息的需求。问答系统是目前人工智能和自然语言处理领域中一个倍受关注并具有广泛发展前景的研究方向。