散热风扇: 散热风扇的技术和性能方面已经完全达到了成熟的阶段，并不断有新技术出现。风扇规格尺寸从8mm到280mm，电压有5V，12V，24V，48V，110V，220V，380V，外形有方形，圆形，橄榄形等。散热风扇，英文名：Cooling fans
站台: 汪苏泷2014年6月27日最新发行的专辑《传世乐章》中的单曲。而影片，正是通过在新旧交替时期从县城走出的一群年轻人的爱情与生活，表达一种对普通人的尊重和生活理解，将普通小人物的经历当成了重要历史进行展现。《站台》是贾樟柯的一段个人成长回忆录，片中有令人熟悉且怀念的县城、县城中的年青人。这是一部充满理想的普通人生活的关照电影。《站台》是贾樟柯的一段个人成长回忆录，片中有令人熟悉且怀念的县城、县城中的年青人
文字编辑: 有些专业媒体，如《财经》杂志，对编辑要求更高，编辑更多的是承担选题策划、组织记者采写稿件的职责。目前除了支持苹果公司（Apple Inc.）开发的Mac OS X操作系统，另外以 GNUstep的形式存在unix兼容操作系统上，像是 Linux。文字编辑可读取的文件格式包括Rich Text Format、Rich Text Format Directory以及纯文本文件
阻值: 阻值，汉语词汇，拼音zǔzhí，意思是表示物质阻碍电流通过的具体数值。单位：欧姆 符号Ω
智能家居: 智能家居（英文：smart home, home automation）是以住宅为平台，利用综合布线技术、网络通信技术、 安全防范技术、自动控制技术、音视频技术将家居生活有关的设施集成，构建高效的住宅设施与家庭日程事务的管理系统，提升家居安全性、便利性、舒适性、艺术性，并实现环保节能的居住环境。智能家居概念的起源很早，但一直未有具体的建筑案例出现，直到1984年美国联合科技公司将建筑设备信息化、整合化概念应用于美国康乃迪克州哈特佛市的CityPlaceBuilding时，才出现了首栋的“智能型建筑”，从此揭开了全世界争相建造智能家居的序幕。与普通家居相比，智能家居不但具有传统的居住功能，兼备建筑、网络通信、管理为一体的高效、舒适、安全、便利、环保的居住环境，还提供全方位的信息交互功能
FEC: 俱乐部胸怀高远，志在培育和联络潜在的商业领袖和管理精英，为渴望进入商界的高级人才提供一个自我教育和相互教育的环境，通过各项活动锻炼会员的综合技能，发掘个人和团队潜能，努力实现培育浙江大学创新创业精神并为创业者搭建校内外沟通桥梁的目的。中国领先的互联网+咨询、技术方案和平台运营企业，以国际化的视野引领互联网+商业模式与技术创新，为全球客户提供世界级互联网+解决方案 重塑边界，助力成长，服务100多家上市公司，帮助1000多家中大型企业实现互联网转型，借助筷云TM矢志为上万家中小企业提供电子商务云平台。FEC即浙江大学未来企业家俱乐部成立于2002年5月20日，是由浙江大学党委研究生工作部和浙江大学国家大学科技园管委会共同支持创办的精英型学生社团
智能车: 是电子计算机等最新科技成果与现代汽车工业相结合的产物。主要由路径识别、角度控制及车速控制等功能模块组成
坏人: 《坏人》是由马嵩惟作词，方炯镔演唱的一首歌。“坏”,本读作pēi,是个从土、不声的形声字，指“未烧过的砖瓦、陶器”。现在“坏”简化为“坏”)
炼狱: 在基督教会的传统中，炼狱是指人死后精炼的过程，是将人身上的罪污加以净化，是一种人经过死亡而达到圆满的境界（天堂）过程中被净炼的体验。在非基督宗教中，也用了许多拟人化的说法来表达炼狱的思想，如轮回或灵魂在阴府中的情况等。炼狱purgatory一词来自拉丁文动词purgare，有精炼之意。“炼狱”同时也是游戏和电影的名字
扫地机: 随着国内生活水平的不断提高，原本一直在欧美市场销售的扫地机器人走入平常百姓家，并被越来越多的人所接受，扫地机器人将在不久的将来像白色家电一样成为每个家庭必不可少的清洁帮手。产品也会由现在的初级智能向着更高程度的智能化程度发展，逐步的取代人工清洁
亮蓝: 亮蓝为食用蓝色色素,属于人工合成色素,是由苯甲醛邻磺酸与N-乙基-N- (3-磺基苄基)-苯胺经缩合、氧化而制得的。亮蓝，又名食用蓝色1号（日本）、食用蓝色2号，属水溶性非偶氮类着色剂。分子式C37H34N2Na2O9S3，相对分子质量792.86
2016年: 农历丙申年（猴年），无闰月，共355天。2016年处于21世纪第2个10年，是中华人民共和国成立67周年。世界气象组织（WMO）确认，2016年成为有记录以来最热年，全球气温高出工业化前约1.1℃
腾讯云: 腾讯在云端完成重要部署，为开发者及企业提供云服务、云数据、云运营等整体一站式服务方案。腾讯云有着深厚的基础架构，并且有着多年对海量互联网服务的经验，不管是社交、游戏还是其他领域，都有多年的成熟产品来提供产品服务。这些正是腾讯云可以提供给这个行业的差异化优势，造就了可支持各种互联网使用场景的高品质的腾讯云技术平台。腾讯云分析（MTA）、腾讯云推送（信鸽）等腾讯整体大数据能力。具体包括云服务器、云存储、云数据库和弹性web引擎等基础云服务
开锁: 开锁又叫“圆锁”，是晋、冀、鲁、豫、陕5省民间流传的一种习俗。同名的还有打开锁头的意思。开锁，是山西民间流传的一种习俗
光强度: 1cd即1000mcd是指单色光源（频率540X10^12HZ）的光，在给定方向上（该方向上的辐射强度为（1/683）瓦特/球面度））的单位立体角发出的光通量。常用于室内照明设计当中的术语，单位为坎德拉（cd)
电机: 电机（英文：Electric machinery，俗称“马达”）是指依据电磁感应定律实现电能转换或传递的一种电磁装置。它的主要作用是产生驱动转矩，作为用电器或各种机械的动力源。电动机也称（俗称马达），在电路中用字母“M”（旧标准用“D”）表示。变压器，在有的书上称之为静止的电机。发电机在电路中用字母G表示
分压: 气体分压是指假设从混合气体系统中排除某种气体以外的所有其他气体，而保持系统体积和温度不变，此时气体所具有的压力，称为混合气体中这一种气体的分压。而电压分压是计算串联的各个电阻如何去分总电压，以及分到多少电压的公式。“分压”在物理学上的概念有气体分压（partial pressure）和电压分压两种
飞行器: 在大气层内飞行的称为航空器，在太空飞行的称为航天器。在大气层内飞行的称为航空器，在太空飞行的成为航天器。随着内燃机的发明和广泛应用，在空气中的飞行也逐渐成为可能
演示作品: 《演示作品》是都市小说，作者是小陶木
警戒: 警戒是防敌袭击和侦察的警卫措施。任务是远距离上发现和监视空中目标，及时发出空袭警报，积极配合反空袭作战。担任警戒的人员要适时进入阵地。警戒通常分为对地面警戒、对空警戒和对海上警戒
赘述: 赘述 zhuìshù意思：说些不必要的细节，多余地叙述
程序设计: 程序设计是给出解决特定问题程序的过程，是软件构造活动中的重要组成部分。在计算机技术发展的早期，由于机器资源比较昂贵，程序的时间和空间代价往往是设计关心的主要因素。程序设计过程应当包括分析、设计、编码、测试、排错等不同阶段。任何设计活动都是在各种约束条件和相互矛盾的需求之间寻求一种平衡，程序设计也不例外。程序设计往往以某种   程序设计语言为工具，给出这种语言下的程序
上位机: 上位机是指可以直接发出操控命令的计算机，一般是PC/host computer/master computer/upper computer,屏幕上显示各种信号变化（液压，水位，温度等）。上位机都有特定的编程，有专门的开发系统，或是已经规定好任务，只能按特定的任务进行操作
报文: 报文(message)是网络中交换与传输的数据单元，即站点一次性要发送的数据块。报文(message)是网络中交换与传输的数据单元，即站点一次性要发送的数据块。完全与系统定义，或自定义的数据结构同义
上门服务: 中文名称：上门服务。如果在维修时遇用户家吃饭而产品一时不能修复，原则上在征得用户同意的前提下继续维修，如确有不便则清理现场，与用户约定等用户吃完饭再回来，明确再回来的时间(不能在用户家吃饭)。在用户家言行一定要规范:工具、工具包、备件等维修时用的或从产品上拆卸下的一切物品必须放在垫布上
独立游戏: 独立游戏制作，是相对于商业游戏制作而存在的另一种游戏制作行为，这一独立游戏点和电影领域中，商业电影和独立制作电影是非常相象的。对于独立制作的理解，国内和国外也不尽相同。只要开发出一款成功的作品，接下来就会延续这品牌继续推出资料片、扩展包等。游戏行业如同电影行业，大型游戏的开发需要资金雄厚的发行商赞助，因此发行商对游戏有很大的决定权
马来西亚: 1963年，马来亚联同新加坡、沙巴及沙捞越组成了马来西亚联邦。马来西亚共分为两大部分，之间有南中国海相隔着：一个是位于马来半岛的西马来西亚，北接泰国，南部隔着柔佛海峡，以新柔长堤和第二通道与新加坡接壤。另一个是东马来西亚，位于婆罗洲岛上的北部，南邻印度尼西亚的加里曼丹，而文莱国则地处沙巴州和砂拉越州之间。2015年9月16日，马来西亚首都吉隆坡爆发了万人游行反华浪潮。主要参与的军事行动有五国联合防卫和联合国维和行动
城市: 城市的行政管辖功能可能涉及较其本身更广泛的区域，其中有居民区、街道、医院、学校、公共绿地、写字楼、商业卖场、广场、公园等公共设施。城市（chéng shì）是“城”与“市”的组合词。人口较稠密的地区称为城市，一般包括了住宅区、工业区和商业区并且具备行政管辖功能。这两者都是城市最原始的形态，严格地说，都不是真正意义上的城市。城市也叫城市聚落，是以非农业产业和非农业人口集聚形成的较大居民点
电子积木: 电子积木就是将导线、灯泡  、二极管、电阻、电容、各种开关、电表、电机、喇叭、集成块等电子元器件固定在塑料片（块）上，用独特的子母扣做成独立可拼装的配件，在产品配置的安装底板上像拼积木一样拼装电路组合。电子积木就是将导线、灯泡 、二极管、三极管、电阻、电容、各种开关、电表、电机、喇叭、集成块等电子元器件固定在塑料片（块）上，用独特的子母扣做成独立可拼装的配件，在产品配置的安装底板上像拼积木一样拼装电路组合
讲座: 讲座，拼音：jiǎng zuò 是一种教学形式,多利用报告会、广播等方式进行。或：由主讲人向学员传授某方面的知识、技巧，或改善某种能力、心态的一种公开半公开的学习形式
缓存: 缓存就是数据交换的缓冲区（称作Cache），当某一硬件要读取数据时，会首先从缓存中查找需要的数据，如果找到了则直接执行，找不到的话则从内存中找。缓存（Cache memory）是硬盘控制器上的一块内存芯片，具有极快的存取速度，它是硬盘内部存储和外界接口之间的缓冲器。由于硬盘的内部数据传输速度和外界介面传输速度不同，缓存在其中起到一个缓冲的作用。电脑里最大的缓存就是内存条了，最快的是CPU上镶的L1和L2缓存，显卡的显存是给GPU用的缓存，硬盘上也有16M或者32M的缓存。千万不能把缓存理解成一个东西，它是一种处理方式的统称
普遍性: 普遍性，指的是事件发生的常见性和必然性。矛盾存在于一切事物中
黑恶势力: 黑恶势力是黑势力与恶势力的通称。是指“黑社会性质的组织”（黑社会组织不等于黑社会性质组织）
手语: 手语(C)是用手势比量动作，根据手势的变化模拟形象或者音节以构成的一定意思或词语，它是听力障碍还有无法言语的人（即聋哑人）互相交际和交流思想的一种手的语言，它是“有声语言的重要辅助工具”，而对于听力障碍的人来说，它则是主要的交际工具。手语与语言的差别则主要在于语音这个问题上和听障人是否以手势进行思维。而聋教育专家、特殊教育工作者和听障人本身根据手语的语言属性认为手语同样是语言，它是语言的一个分支，是一种特殊的语言形式
GPS模块: GPS模块就是集成了RF射频芯片、基带芯片和核心CPU，并加上相关外围电路而组成的一个集成电路。目前GPS模块的GPS芯片大部分还是采用全球市占率第一的SiRFIII系列为主。现阶段也持续在芯片升级，比方sirf4，然后又是sirf5，总体灵敏度提高了不少，缩短了定位时间，同时也帮助了客户快速的进入了定位应用状态。可将同时追踪多达20颗卫星，并迅速确定，1 Hz导航更新
2014年: 农历甲午年（马年），闰九月，共384天。2014年是一个平年，第一天是星期三，是农历甲午年，根据干支纪年法，立春是一个新纪年的开始，即到了2月4日立春（农历正月初五）开始属马，之前属蛇。2014年又是：巴西世界杯、南京青年奥林匹克运动会、俄罗斯索契冬季奥林匹克运动会举办年
电子电路: 《电子电路》是2010年华中科技大学出版社出版的图书，作者是瞿安连。电子电路是一部书籍，以电子技术的最新进展为蓝本讨论了电子电路的基本原理，以及分析与设计方法，并介绍了多种类型集成电路的工作原理、使用方法和典型应用电路。根据系统的指标和功能框图，明确各部分任务，进行各单元电路的设计，参数计算和器件选择
语法: 句法主要是指短语和句子等语法单位的构成和变化规则。一指语法学，是探索并描写语法结构的科学，是语法学者对客观存在的语法体系的认识和说明。语法是语言学的一个分支，研究按确定用法来运用的词类、词的屈折变化或表示相互关系的其他手段以及词在句中的功能和关系。语法事实本身没有分歧，但由于语法学者占有的材料，观察角度，分析方法不一致，语法学体系是有分歧的。语法有两个   含义，一指语法结构规律本身，即语法事实
电缆线: VideoTwistTM电缆是布线业界领先的Belden CDT公司推出的新型的Brilliance&reg ，该电缆采用非屏蔽双绞线（UTPs），支持高清晰的视频传输和准确无误的数据传输以及KVM（键盘、显示器和鼠标）技术，是专业视频、数据应用的最佳解决方案，同时为分量视频应用提供了优异的低偏移性能，符合并适用于TIA/EIA标准
FFT: FFT（Fast Fourier Transformation），即为快速傅氏变换，是离散傅氏变换（DFT）的快速算法，它是根据离散傅氏变换的奇、偶、虚、实等特性，对离散傅立叶变换的算法进行改进获得的
唐都: 618年，李渊称帝，建立唐朝，改大兴为长安，此后进一步修建和完善。盛唐时期成为当时规模最大、最繁华的国际大都市，是东西方文化交流的汇集地
开发板: 开发板（demoboard）是用来进行嵌入式系统开发的电路板，包括中央处理器、存储器、输入设备、输出设备、数据通路/总线和外部资源接口等一系列硬件组件。开发板一般由嵌入式系统开发者根据开发需求自己订制，也可由用户自行研究设计。开发板一般由嵌入式系统开发者根据开发需求自己订制，也可由用户自行研究设计。常见的开发板有51、ARM、FPGA、DSP开发板
食指: 食指，本名郭路生（1948—   ），山东鱼台人。1993年，加入北京市作家协会，五月出版《食指黑大春现代抒情诗合集》。写出《新兵》《架设兵之歌》《澜沧江，湄公河》等反映部队生活的诗歌。另外著名当代诗人郭路生的笔名也叫“食指”
红外线接收器: 红外线接收器是一种可以接收红外信号并能独立完成从红外线接收到输出与TTL电频信号兼容的器件，体积和普通的塑封三极管差不多，适合于各种红外线遥控和红外线数据传输
可调电位器: 可调电位器，是一种可调的电子元件，由一个体和一个转动或滑动系统组成。可调电位器，是一种可调的电子元件，由一个体和一个转动或滑动系统组成。在裸露的电阻体上，紧压着一至两个可移金属触点，触点位置确定电阻体任一端与触点间的阻值
故事王: 《故事王》上映时间：2013年日又名传奇故事
实时时钟: 有些时钟芯片为了在主电源掉电时，还可以工作，需要外加电池供电。实时时钟芯片是日常生活中应用最为广泛的消费类电子产品之一。实时时钟的缩写是RTC(Real_TimeClock)
主讲: 主讲是汉语词汇，出处《新齐谐·敦伦》，解释担任讲授或讲演
骑行: 骑行是一种健康自然的运动旅游方式 ，能充分享受旅行过程之美。一辆单车一套骑行装备即可出行，简单又环保。驶过颠簸的路途，超越黑暗的隧道，在不断而来的困难当中体验挑战，在遥远的他乡体验风情，在旅途的终点体验成功
路由器: 因此，路由器具有判断网络地址和选择IP路径的功能，它能在多网络互联环境中，建立灵活的连接，可用完全不同的数据分组和介质访问方法连接各种子网，路由器只接受源站或其他路由器的信息，属网络层的一种互联设备。路由器（Router），是连接因特网中各局域网、广域网的设备，它会根据信道的情况自动选择和设定路由，以最佳路径，按前后顺序发送信号。路由器（Router）又称网关设备（Gateway）是用于连接多个逻辑上分开的网络，所谓逻辑网络是代表一个单独的网络或者一个子网。路由和交换机之间的主要区别就是交换机发生在OSI参考模型第二层（数据链路层），而路由发生在第三层，即网络层。路由器是互联网络的枢纽，"交通警察"
见谅: 见谅，汉语词汇。”《封神演义》第三二回：“将军雅爱，念吾俱是武臣，被屈脱难，贤明自是见亮
病状: 每道逢贼，或欲逼略， 熹 辄言其病状，以此得免。因以泥涂 仲伯 妇面，载以鹿车，身自推之。熹 责怒不听
光线传感器: 光线传感器是可以根据手机所处环境的光线来调节手机屏幕的亮度和键盘灯。而且光线传感器在进入睡眠模式的时候，会发出蓝色周期性闪动的光，甚是好看。光线传感器，也就是感光器，是能够根据周围光亮明暗程度来调节屏幕明暗的装置
video: <video> 标签的作用是在 HTML 页面中嵌入视频元素。video标签定义视频，比如电影片段或其他视频流。video>是 HTML 5 中的新标签。广泛应用于电视、摄录像、雷达、计算机监示器中。英文名称：Video：视频　　指0～10兆赫范围内的频率
电磁阀: 电磁阀（Electromagnetic valve）是用电磁控制的工业设备，是用来控制流体的自动化基础元件，属于执行器，并不限于液压、气动。电磁阀有很多种，国内外的电磁阀从原理上分为三大类(即：直动式、分步童先导式)，而从阀瓣结构和材料上的不同与原理上的区别又分为六个分支小类(直动膜片结构、分步重片结构、先导膜式结构、直动活塞结构、分步直动活塞结构、先导活塞结构)。电磁阀可以配合不同的电路来实现预期的控制，而控制的精度和灵活性都能够保证。电磁阀可以配合不同的电路来实现预期的控制，而控制的精度和灵活性都能够保证
歌曲: 歌曲可以给人带来精神上的鼓励与振奋，同时也是对心灵的升华，带人们走进另一个音乐世界。歌曲所具有的极高的审美价值，完全可以起到修复人类心灵的作用。歌曲的变化反映时代的变迁，不同时期有不同的特点，不同的人也有不同的记忆和感受。歌曲的变化反映时代的变迁，不同时期有不同的特点，不同的人也有不同的记忆和感受。歌曲是由歌词和曲谱相结合的艺术形式，也是一种表现形式词曲一一相应
自动泊车: 汽车制造商之所以开发能够自动泊车的汽车，是因为他们意识到消费者的需求。自动泊车是指驾驶人找到了一个理想的停车地点，只需轻轻启动按钮、坐定、放松，其他一切即可自动完成，不必再来回折腾。且自动泊车技术同样适用于主动避撞系统，并最终实现汽车的自动驾驶。汽车制造商之所以开发能够自动泊车的汽车，是因为他们意识到消费者的需求
调试: 调试是保证所提供的设备能够正常运行的必须程序，所有费用由设备提供商负担。韩少华 《序曲》：“一阵调试琴弦的声音乘空儿飘进门来。从心理学的角度考虑，开发人员和调试人员不应该是同一个人
保护电路: 鉴于电源电路存在一些不稳定因素，而设计用来防止此类不稳定因素影响电路效果的回路称作保护电路。由两个场效应管和专用保护集成块S--8232组成，过充电控制管FET2和过放电控制管FET1串联于电路，由保护IC监视电池电压并进行控制，当电池电压上升至4.2V时，过充电保护管FET2截止，停止充电。鉴于电源电路存在一些不稳定因素，而设计用来防止此类不稳定因素影响电路效果的回路称作保护电路
网络通信: 网络通信是通过网络将各个孤立的设备进行连接，通过信息交换实现人与人，人与计算机，计算机与计算机之间的通信。网络，是用物理链路将各个孤立的工作站或主机相连在一起，组成数据链路，从而达到资源共享和通信的目的。通信是人与人之间通过某种媒体进行的信息交流与传递。通信是人与人之间通过某种媒体进行的信息交流与传递。应根据需要来选择合适的网络协议
锂电池: 锂电池大致可分为两类：锂金属电池和锂离子电池。“锂电池”，是一类由锂金属或锂合金为负极材料、使用非水电解质溶液的电池。可充电电池的第五代产品锂金属电池在1996年诞生，其安全性、比容量、自放电率和性能价格比均优于锂离子电池。旅客乘飞机托运禁止携带锂电池。电池运用的反应方程式为：Li+MnO2=LiMnO2该反应为氧化还原反应，放电
压力传感器: 压力传感器是工业实践中最为常用的一种传感器，其广泛应用于各种工业自控环境，涉及水利水电、铁路交通、智能建筑、生产自控、航空航天、军工、石化、油井、电力、船舶、机床、管道等众多行业，下面就简单介绍一些常用传感器原理及其应用。另有医用压力传感器。有时把这两种元件的功能集于一体。YY-YL100压力传感器[1]是将压力转换为电信号输出的传感器
奖品: 奖品 是奖励的“物品”（可以是物质的或者概念性的），通过努力获得的如在比赛活动,为了奖励优胜者而给予的“物品”
机器学习: 专门研究计算机怎样模拟或实现人类的学习行为，以获取新的知识或技能，重新组织已有的知识结构使之不断改善自身的性能。它的应用已遍及人工智能的各个分支，如专家系统、自动推理、自然语言理解、模式识别、计算机视觉、智能机器人等领域。机器学习（Machine Learning,ML）是一门多领域交叉学科，涉及概率论、统计学、逼近论、凸分析、算法复杂度理论等多门学科。其中尤其典型的是专家系统中的知识获取瓶颈问题，人们一直在努力试图采用机器学习的方法加以克服。它是人工智能的核心，是使计算机具有智能的根本途径
天气预报: 利用卫星云图照片进行分析，能提高天气预报的准确率。天气预报就是应用大气变化的规律，根据当前及近期的天气形势，对某一地未来一定时期内的天气状况进行预测。它是根据对卫星云图和天气图的分析，结合有关气象资料、地形和季节特点、群众经验等综合研究后作出的。如我国中央气象台的卫星云图，就是我国制造的“风云一号”气象卫星摄取的。天气预报就时效的长短通常分为三种：短期天气预报（2～3天）、中期天气预报（4～9天），长期天气预报（10～15天以上），中央电视台每天播放的主要是短期天气预报
照顾: 语出《朱子语类》卷九四：“才有照顾不到处，这便是恶。”元无名氏《千里独行》第一折：“救了俺这姊妹残生，顷刻俺便似泰山般一家儿倚靠着你，从今后照顾你这亲戚。古之圣贤战战兢兢过了一生，正谓此也。出自《朱子语类》卷九四：“才有照顾不到处，这便是恶。照顾，指照料
磁生电: 原理：闭合电路的一部分导体做切割磁感线运动时，在导体上就会产生电流的现象叫电磁感应现象，产生的电流叫做感应电流。原理：闭合电路的一部分导体做切割磁感线运动时，在导体上就会产生电流的现象叫电磁感应现象，产生的电流叫做感应电流
标题: 标题的意思为“标明文章、作品等内容的简短语句。标题，《现代汉语辞典》解释的意思为“标明文章、作品等内容的简短语句。常言道：看书先看皮，看报先看题。标题的好坏对于决定一篇文章成败的作用，不容小视
小夜灯: 小夜灯灯光柔和，在茫茫黑暗中，起到指引照明的作用，同时又兼具一灯多用之功能，加入熏香精油即成薰香灯，加入驱蚊精油或驱蚊液可成环保驱蚊灯，能达到无毒驱蚊的效果，特别适应婴童居室。加入食醋则可达到消毒杀菌、净化空气之功效。新装修居室可以分解有害气体。加入食醋则可达到消毒杀菌、净化空气之功效。小夜灯灯光柔和，在茫茫黑暗中，起到指引照明的作用
抽水: 抽水，是个贬义词，指某人在某事物或人拿取利益
日期: 日期，可以解释为，约定的日子和时间
见证奇迹: 《见证奇迹》又名《魔幻7月 见证奇迹》，口号是：魔幻7月，见证奇迹
音乐树: 动听的诗歌、童谣，是文字的图画，在欣赏美的同时，还会感受到韵律的和谐。有趣的童话，让他们展开想象的翅膀，在幻想的天空高飞
同学: 同学通常指曾经于同一时间在一起学习的人，而并非与自己同时在学的校友，一般比自己较高年级的同学称为学长、学姊，比自己较低年级的同学称为学弟、学妹，一般而言同学友谊比较纯朴，没有重大的利益权力的竞争，因此不少人与同学成为好友，甚至知己、密友。而并非与自己同时在学的校友一般不会称为同学。因此不少人与同学成为好友，甚至知己、密友
连通图: 如果此图是有向图，则称为强连通图（注意：需要双向都有路径）。在一个无向图 G 中，若从顶点vi到顶点vj有路径相连（当然从vj到vi也一定有路径），则称vi和vj是连通的。在图论中，连通图基于连通的概念。如果G是有向图，那么连接vi和vj的路径中所有的边都必须同向。图的连通性是图的基本性质
充电电池: 充电电池，是充电次数有限的可充电的电池，配合充电器使用。市场上一般卖5号、7号，但是也有1号。截止至2012年2月只有五种：镍镉、镍氢、锂离子、铅蓄、铁锂。充电电池的好处是经济、环保、电量足、适合大功率、长时间使用的电器（如随身听、电动玩具等）。充电电池的电压比型号相同的一次性电池低，AA电池（5号充电）是1.2伏，9V充电电池实际上是 8.4伏
十五块钱: 《十五块钱》是连载于起点文学网的影视同人类小说，作者是风舞残阳
手机客户端: 以手机客户端产生的产业同样发展迅猛，企业可以无需依赖手机媒体、手机应用即可自己实现便捷、有效的移动营销。她通过为企业提供定制手机客户端，而使企业可以无需依赖手机媒体、手机应用即可自己实现便捷、有效的移动营销。2013年，中国联通抢先推出10010手机客户端，复盖苹果iOS（iPhone）、谷歌安卓（Android）两大主流智能手机平台
12月13日: 12月13日是公历一年中的第347天（闰年第348天），离全年结束还有18天。12月13日是公历一年中的第347天（闰年第348天），离全年结束还有18天。2014年2月27日下午27日下午，十二届全国人大常委会第七次会议经表决通过了两个决定，分别将9月3日确定为中国人民抗日战争胜利纪念日，将12月13日确定为南京大屠杀死难者国家公祭日
sender: sender是pinback乐队的专辑《Summer in Abaddon》中收录的一首歌曲，于2004年发行
噪音: 从环境保护的角度看：凡是妨碍到人们正常休息、学习和工作的声音，以及对人们要听的声音产生干扰的声音，都属于噪声。是由发音体不规则的振动产生的（区别于乐音），从物理学的角度来看：噪声是发声体做无规则振动时发出的声音。噪声是一类引起人烦躁、或音量过强而危害人体健康的声音。噪声是声波的频率、强弱变化无规律、杂乱无章的声音。从生理学而言凡是妨碍人们正常休息、学习和工作的声音，以及对人们要听的声音产生干扰的声音
开源硬件: 开源硬件指与自由及开放原始码软件相同方式设计的计算机和电子硬件。其中，Arduino的诞生可谓开源硬件发展史上的一个新的里程碑。开源硬件开始考虑对软件以外的领域开源，是开源文化的一部分
加湿器: 加湿器可以给指定房间加湿，也可以与锅炉或中央空调系统相连给整栋建筑加湿。加湿器可以给指定房间加湿，也可以与锅炉或中央空调系统相连给整栋建筑加湿。加湿器分为风扇加湿器和超声波加湿器两种，前者的辐射污染远远大于后者
模范: 模范，是个褒义词，本指制造器物时所用的模型，引申为值得人学习或取法的榜样
床底下: 保尔·布莱特毕业于工程和设备学专业，现在一家大型化工厂工作，为塑料工业方面的专家。在他的孩子很小的时候，就开始写故事，直到孩子们都长大离开了家仍笔耕不息，已在各种书集中发表了大量诗作。代表作《床底下》和《安静一下
注释: 现代书籍注释列于正文当页之下，称脚注，亦称本面注。列于文章之后或列于书籍之后者称篇末注。古籍注释列在正文之中，有双行夹注和夹注。古籍注释列在正文之中，有双行夹注和夹注。列于文章之后或列于书籍之后者称篇末注
直接人工: 直接人工，是指企业在生产产品和提供劳务过程中，直接从事产品的生产的工人的工资、津贴、补贴和福利费以及社保等
给手机充电: 《给手机充电》，是一款解密小游戏，游戏大小为3.2M
乐曲: 音乐的定义仍存在着激烈的争议，但通常可以解释为一系列对于有声、无声具有时间性的组织，并含有不同音阶的节奏、旋律及和声。音乐的定义仍存在着激烈的争议，但通常可以解释为一系列对于有声、无声具有时间性的组织，并含有不同音阶的节奏、旋律及和声。在中国的音乐史上，于元朝产生大变化，把诗词之美融入乐声中而风行之，据考证，论曲起源可上溯至远古生民之始，孔子亦诗三百篇作弦歌
2012年: 公元2012年，公历闰年，共366天，53周。2012年是中华人民共和国中央人民政府成立第63周年。春节是公元2012年1月23日。2012年还是中国百合奠基日选择年期，8月2日——8月8日是百合奠基日/纪念日
HUB: HUB是一个多端口的转发器，在以HUB为中心设备时，即使网络中某条线路产生了故障，并不影响其它线路的工作。HUB是一个多端口的转发器，当以HUB为中心设备时，网络中某条线路产生了故障，并不影响其它线路的工作。集线器工作在局域网(LAN)环境，应用于OSI参考模型第一层，因此又被称为物理层设备。所以HUB在   局域网中得到了广泛的应用
整蛊: 整蛊，就是整人，搞恶作剧的意思。蛊是一种以毒虫作祟害人的巫术，是一种较古老的神秘巫术，主要流行于我国南方各地和一些少数民族中。整蛊就是整人，搞恶作剧的意思
室内环境检测: 室内环境检测就是运用现代科学技术方法以间断或连续的形式定量地测定环境因子及其他有害于人体健康的室内环境污染物的浓度变化，观察并分析其环境影响过程与程度的科学活动。室内环境检测治理研究表明：中国是人口大国，通过对各地方性人口健康调查发现室内环境检测指数较好的环境人口普遍寿龄高于居住在环境较差的地方的寿龄。这是室内环境检测中不可否认的结果
另一个人: 《另一个人》是由Rainmark影业、Gotham Productions联合制作的88分钟剧情影片
接地: 在系统发生接地故障时，会有上千安培的工作电流流过接地电极，然而该电流会被继电保护装置在0.05~0.1s内切除，即使是后备保护，动作一般也在1s以内。保护接地只是在设备绝缘损坏的情况下才会有电流流过，其值可以在较大范围内变动。工作接地就是由电力系统运行需要而设置的（如中性点接地），因此在正常情况下就会有电流长期流过接地电极，但是只是几安培到几十安培的不平衡电流
数组: 这些按序排列的同类数据元素的集合称为数组。数组有上界和下界，数组的元素在上下界内是连续的。数组是在程序设计中，为了处理方便， 把具有相同类型的若干变量按有序的形式组织起来的一种形式。数组是计算机编程语言上，对于“Array”的中文称呼
DOF: 除了平移的自由度外，还有转动及振动自由度  在统计学里,自由度（degree of freedom, df）是指当以样本的统计量来估计总体的参数时，样本中独立或能自由变化的数据的个数称为该统计量的自由度。力学系统中是指独立坐标的个数
超声波测距仪: 装置上有设置瞄点装置，只要把仪器对准要测量的目标，就会出现一点在测距仪的显示屏幕上
离开后: 郑颖杰(EJV)，全能音乐人
震动开关: 震动开关，正确的名称应该称为震动传感器，也就是在感应震动力大小将感应结果传递到电路装置，并使电路启动工作的电子开关。一般的产品只有灵敏度的要求并没有方向性的要求，因此要先了解使用者的产品的用途，才能建议使用者使用那种型号的弹簧开关。震动开关因为拥有灵活且灵敏的触发性，成为许多电子产品中不可或缺的电子元件
Boom: 李民浩韩国本名：이민호（音：Lee Min ho），韩国艺人，歌手、演员并做过娱乐节目《强心脏》的主持人，代表作品《彩虹罗曼史》、《Boom up》 ，Boom目前在强心脏和star king两档节目上面用心的主持
发光二极管: 当电子与空穴复合时能辐射出可见光，因而可以用来制成发光二极管。磷砷化镓二极管发红光，磷化镓二极管发绿光，碳化硅二极管发黄光，铟镓氮二极管发蓝光。据《中国LED照明产业市场前瞻与投资战略规划分析报告前瞻》数据显示，2009年，全球LED路灯装置数量约250万盏，渗透率达到1%，2010年，全球LED路灯可达到450万盏，渗透率达到2%以上。发光二极管简称为   LED。砷化镓二极管发红光，   磷化镓二极管发绿光，   碳化硅二极管发黄光，   氮化镓二极管发蓝光
火情: 火情是一个汉语词汇，拼音为huǒ qíng，基本意思是火灾现场火燃烧的范围、程度等情况
电子: 电子与正电子会因碰撞而湮灭，在这过程中，创生一对以上的光子。电子与正电子会因碰撞而互相排斥，在这过程中，创生一对以上的光子。电子与正电子会因碰撞而互相湮灭，在这过程中，创生一对以上的光子（光子的质量比电子小得多，电子的质量：9.10938215（45）×10⁻³¹千克。电子属于轻子类，以引力、电磁力和弱核力与其它粒子相互作用。电子带有1/2自旋，是一种费米子
电力: 20世纪出现的大规模电力系统是人类工程科学史上最重要的成就之一，是由发电、输电、变电、配电和用电等环节组成的电力生产与消费系统。不可否认新技术的不断出现使得电力成为人们的必需品。它将自然界的一次能源通过发电动力装置转化成电力，再经输电、变电和配电将电力供应到各用户。成为人类历史18世纪以来，世界发生的三次科技革命之一，从此科技改变了人们的生活。电力是以电能作为动力的能源
从前有座山: ，2013年12月22日起北京人艺最新创作的话剧《从前有座山》在北京人艺实验剧场上演，由张幼梅导演与编剧、著名表演艺术家蓝天野担任艺术指导，魏小军 、张胤哲 、王阳 、 龙一仪等主演，该剧聚焦近年来愈演愈烈的为现实利益而“假离婚”现象，从全新角度探讨人们在生活的困境中应该如何选择的问题。《从前有座山》剧情悬念重重，跌宕起伏，对时代有着敏锐的观察力和另类的阐述角度。在直面社会现象的同时，希望提供一个新的视角来解读童谣，能够引起观众对人性的思考。《从前有座山》是流传民间的童谣：从前有座山，山里有座庙，庙里有个老和尚和一个小和尚
usb: USB，是英文Universal Serial Bus（通用串行总线）的缩写，是一个外部总线标准，用于规范电脑与外部设备的连接和通讯。下一代USB接口将会有改动方向，下一代的Type-C USB接口，可支持正反两面插，并且传输数据信号强，但目前（2014年）生产商有限。是应用在PC领域的接口技术
电学: 随着科学技术的发展，某些带有专门知识的研究内容逐渐独立，形成专门的学科，如电子学、电工学等。主要研究“电”的形成及其应用。自从18世纪中叶以来，对电的研究逐渐蓬勃开展。现在无论人类生活、科学技术活动以及物质生产活动都已离不开电。“电”一词在西方是从希腊文琥珀一词转意而来的，在中国则是从雷闪现象中引出来的
宣传单: 宣传单又称宣传单页，是商家为其宣传自己的一种印刷品，一般为单张双面印刷或单面印刷，单色或多色印刷，材质有传统的铜版纸，和现在流行的餐巾纸。一般为单张双面印刷或单面印刷，单色或多色印刷，材质有传统的铜版纸，和现在流行的餐巾纸。宣传单又称宣传单页，一般为单张双面或单面，是商家为其宣传自己的一种印刷品
的的: 古代文学书面用语。”宋 贺铸《薄幸》词：“淡妆多态，更的的、频回眄睐。唐 苏颋 《陈仓别陇州司户李维深》诗：“情言正的的，春物宛迟迟
Base: Base——OpenOffice.org套件之一，其功能类似于微软Office(TM)里的Access。Base——OpenOffice.org的套件之一，其功能类似于微软Office(TM)的Access。对于简单的数据库工作它也可以直接访问 dBASE 文件
物流: 物流管理（Logistics Management）是指在社会生产过程中，根据物质资料实体流动的规律，应用管理的基本原理和科学方法，对物流活动进行计划、组织、指挥、协调、控制和监督，使各项物流活动实现最佳的协调与配合，以降低物流成本，提高物流效率和经济效益。科技名称定义：物流英文名称：logistics 定义：供应链活动的一部分，是为了满足客户需要而对商品、服务以及相关信息从产地到消费地的高效、低成本流动和储存进行的规划、实施与控制的过程。中国的“物流”一词是从日文资料引进来的外来词，源于日文资料对"Logistics"一词的翻译“物流”
茁壮成长: 茁壮成长的意思通常是指植物在阳光的照耀下吮吸阳光的照射，一天一个样。有时候是指人们盼望好的事物向美好的方向发展。茁壮成长的意思通常是指植物在阳光的照耀下吮吸阳光的照射，一天一个样。不过通常比喻父母长辈们希望青少年儿童健康快乐的成长
导论: 导论导：①指导。导论按领域可以划分为人文社科文章导论与自然科学文章导论 按照学科可以分为法学导论 基因导论文学导论 等 其中法学导论使用最多，泛指部门法的基本概述。带领：导游|导航|领导|因势利导
超声波: 超声波是一种频率高于20000赫兹的声波，它的方向性好，穿透能力强，易于获得较集中的声能，在水中传播距离远，可用于测距、测速、清洗、焊接、碎石、杀菌消毒等。因此，我们把频率高于20000赫兹的声波称为“超声波”。在中国北方干燥的冬季，如果把超声波通入水罐中，剧烈的振动会使罐中的水破碎成许多小雾滴，再用小风扇把雾滴吹入室内，就可以增加室内空气湿度，这就是超声波加湿器的原理。它方向性好，穿透能力强，易于获得较集中的声能，在水中传播距离远，可用于测距、测速、清洗、焊接、碎石、杀菌消毒等。超声波可以根据原理分可以分为检测超声和功率超声
传感器: 传感器（英文名称：transducer/sensor）是一种检测装置，能感受到被测量的信息，并能将感受到的信息，按一定规律变换成为电信号或其他所需形式的信息输出，以满足信息的传输、处理、存储、显示、记录和控制等要求。它是实现自动检测和自动控制的首要环节。传感器的特点包括：微型化、数字化、智能化、多功能化、系统化、网络化
环境监测: 国务院办公厅2015年8月12日印发《生态环境监测网络建设方案》(以下简称“《方案》”)，提出到2020年，初步建成陆海统筹、天地一体、上下协同、信息共享的生态环境监测网络
惨剧: 语出邹鲁 《中国国民党史稿》第三篇：“死难之多，洵为吾党革命以来之惨剧云。1. 极为惨痛的事情。” 2. 极为剧烈
财产损失: 2、财产损失是指纳税人在一个纳税年度内生产经营过程中发生的固定资产、流动资产的盘亏、毁损、报废净损失坏账损失以及遭受自然灾害等人类无法抗拒因素造成的非常损失
失联: 失联，是指应当随时保持与地面有通讯联络的物体，而在运行中，失去联系的现象。2014年8月21日，一名女大学生在济南火车站转车时误上一辆黑车，随后被黑车司机绑架、囚禁4天，其间遭遇多次殴打、恐吓、强奸、性虐。失联事件还有2014年03月25日，有关媒体报道，河南“饼干大王”朱东海失联农发行累计贷款近3亿
5月24日: 5月24日是公历一年中的第144天（闰年第145天），离一年的结束还有221天。1787年5月24日大陆会议在费城召开。1954年5月24日晶体管计算机诞生
红外测距传感器: 红外测距传感是用红外线为介质的测量系统，主要应用于现代科技，国防和工农业领域。近期来全球自然灾害频发，像近期的四川、智利的大地震、日本海啸，严重影响人类生命安全，而二次灾难又对营救者带来了极大的风险，这时搜救机器人就可以很好的代替营救者来搜救被困人群。红外测距传感是用红外线为介质的测量系统，主要应用于现代科技，国防和工农业领域
出局: 出局：泛指在体育比赛中因失利而不能继续参加后一阶段的比赛，比喻人或事物因不能适应形势或不能达到某种要求而无法在其领域继续存在下去
耳机: 耳机是一对转换单元，它接受媒体播放器或接收器所发出的电讯号，利用贴近耳朵的扬声器将其转化成可以听到的音波。如今对于耳机越来越要求细分化，根据不同的场合选择合适的耳机已经成为潮流生活的一种象征。“耳机”的拼音：“ěr jī ”。从整个音频行业的发展来看，无线耳机仍然算是新生事物，发展时间并不长，目前仍处在上升期，用户需求不断提升，用户对无线耳机的期望值也在提高，这就是对行业提出的新的考验。亦可隔开周围环境的声响，对在录音室、DJ、旅途、运动等在噪吵环境下使用的人很有帮助
手套: 这是由于网络游戏的兴起，使得铺天盖地的游戏装备名称出现，由于游戏玩家数量众多，尤其是相比于传统行业，使得网络上的手套信息更多的却是网络游戏装备的相关信息，手套最早起源于古希腊。手套用各种皮革、橡胶、针织物或机织物裁剪缝制而成。手套按材料分有棉纱、毛绒、皮革,超纤，布料，橡胶等。手套是包裹手的服饰或保护器材。但是除了传统意义上的手套，现在的手套更有了深一层的含义，与传统的手套迥然不同
广告牌: 广告牌是拉动系统中，启动下一个生产工序，或搬运在制品到下游工序的一个信号工具。这个术语在日语中是“信号”或“信号板”的意思。可有三维板、灯布、吸塑、汽车烤漆、扣板、铝塑板等。这个术语在日语中是“信号”或“信号板”的意思，泛指一切传递广告信息的户外媒体
彩灯: 彩灯，又名花灯，是我国普遍流行的传统的民间的综合性的工艺品。在古代，其主要作用是照明，由纸或者绢作为灯笼的外皮，骨架通常使用竹或木条制作，中间放上蜡烛或者灯泡，成为照明工具。受汉族文化影响，在亚洲华人地区，许多国家的庙宇中，灯笼也是相当常见的物品。彩灯艺术也就是灯的综合性的装饰艺术
专有名词: 英文：Proper Noun
出品: 现实生活中，往往会在产品包装的背面标有：A-某某公司出品、B-某某公司制造/生产、C-某某公司制造出品、这里A的出品所指的是：该产品的相关权利属于该公司所有，该产品是由此公司开发设计，按自己公司的意原所出的产品，但不一定会自己生产该产品。多数情况下，他们掌握着制作资金投入的决定权，但不一定参与实际操作。A项后面一般都有B项标注，A和B的公司可以不是相同一家，也可以是相同的
在空间: 《在空间》是2013年1年清华大学出版社出版的书籍，作者是杨宇振
2013年: 农历癸巳年（蛇年），无闰月，共355天。中华人民共和国成立64周年。2013年是一个平年，第一天是星期二。2013年是一个平年，第一天是星期二，农历癸巳年。中华人民共和国成立64周年
杜邦线: 是美国杜邦公司生产的有特殊效用的缝纫线。电子行业杜邦线可用于实验板的引脚扩展，增加实验项目等。可以非常牢靠地和插针连接，无需焊接，可以快速进行电路试验
曲调: 音乐的首要要素。曲调有两个基本要素，即旋律线（或称音高线）和节奏。曲调是让听众获取音乐内容的主要媒介。由高音向低音方向盘进行称下行。由低音向高音方向进行你上行
看日出: 《看日出》是由中国建筑工业出版社发行的一本图书，作者是邹德侬
起床: 起床，本意离床下地、起身，喻指病愈。语出《儒林外史》第四八回：“饿到六天上，不能起牀（床）
女生: 3.戏曲表演中的专有名词，指由女性扮演的生旦净末丑中的“生角”，故称女生。一般定义在3月7日这一天，也就是三八妇女节前一天。具体节日举办由女生节的高校或组织根据实际情况而定
吕铮: 吕铮：北京人，80后作家、词曲作者、警察，中国作协会员，全国公安文联会员，北京作协会员，北京侦探推理文艺协会理事，鲁迅文学院第十五届高研班学员，连续三届金盾文学奖获得者。吕铮：北京人，80后作家、词曲作者、警察，中国作协会员，全国公安文联会员，北京作协会员，北京侦探推理文艺协会理事，鲁迅文学院第十五届高研班学员，连续三届金盾文学奖获得者。2016年 6月25日，吕铮的《名提》获得“首届海峡两岸新锐作家好书评选”十部作品之一
电源电路: 电源电路是指提供给用电设备电力供应的电源部分的电路设计，使用的电路形式和特点。电源电路一般可分为开关电源电路，稳压电源电路，稳流电源电路，功率电源电路，逆变电源电路，DC-DC电源电路，保护电源电路等。式连接起来，为电荷流通提供了路径的总体，也叫电子线路或称电气回路，简称网络或回路
风靡世界: 风靡世界，形容事物在整个世界很风行,像风吹倒草木一样
任天堂: 任天堂开发了游戏史上最热销游戏系列超级马里奥和精灵宝可梦，以及全球媒体综合评价最高的塞尔达传说系列。任天堂在全球游戏业中始终坚持反对暴力和色情， 并以开发优秀的全年龄游戏为已任，保持着弥足珍贵的社会责任和企业操守。经过多年时间，任天堂已成为全球最大的电玩游戏机制造商
弹幕: 而弹幕，顾名思义是指子弹多而形成的幕布，大量吐槽评论从屏幕飘过时效果看上去像是飞行射击游戏里的弹幕。弹幕（barrage，dànmù），中文词语，原意指用大量或少量火炮提供密集炮击。现常应用于观影过程实时吐槽的评论，体现为从屏幕飘过时效果看上去像是飞行射击游戏里的评论
校园时光: 还有面对重大的校长职务，小陆该怎么办呢。由于外公的遗言而让她意外当上超名门学校。《校园时光》是日本漫画家田岛美美，以校园为题材的作品。青叶陆原本是一个普通的高中生。在电车上一见钟情的男生，居然也是玛学的学生
触摸开关: 能实现更智能化、操作更方便的触摸开关有传统开关不可比拟的优势，是目前家居产品的非常流行的一种装饰性开关。他一般是指应用触摸感应芯片原理设计的一种墙壁开关，是传统机械按键式墙壁开关的换代产品。触摸开关，是科技发展进步的一种新兴产品
字模: 先用电镀的方法，在手工雕刻的铅字上镀一层较厚的铜，然后把铜层剥下来，从背面浇铸铅或锌，再锯成小块，镶嵌在铜坯上，便制成了字模。字模是用铜或其它金属制成的，一般是凹型字符的铸字模具
音响效果: 运用多种专用器具和技法，模拟或再现各种声响，如风声、雨声、枪炮声等，创造舞台真实感，以烘托环境气氛，增强艺术感染力。音响效果，指专为配合戏剧演出所设计、配置的种种音响，简称“效果”
避障: 避障是根据物体拥有的各种感官器件，
imgcache: imgcache，是nokia手机的塞班操作系统必备生成的一个文件夹
恋爱的温度: 《恋爱的温度》是2013年3月21日上映的一部韩国影片，该片由鲁德执导，李民基、金敏喜、罗美兰、崔武盛等人主演。《恋爱的温度》(韩语：연애의 온도，英语：Very Ordinary Couple)，是一部2013年上映的韩国爱情电影。李民基和金敏喜在片中饰演职场同事东熙和英，3年来都小心翼翼的避开其他同事的目光，而进行着秘密的“办公室恋爱”。两人时而甜蜜多情，时而又在无意间伤害对方，恋爱的温度也时不时发生着变化。讲述的是因为时而热烈时而冰冷的“恋爱的温度”，恋人们也反复着恋爱和分手的过程
蓝色的: 《蓝色的》是连载在起点中文网的言情类小说，作者是只是那阵风
分贝: 分贝（decibel）是量度两个相同单位之数量比例的计量单位，主要用于度量声音强度，常用dB表示。声音其实是经媒介传递的快速压力变化。每一秒内压力变化的次数叫作频率，量度单位是赫兹(Hz)，其定义为每秒的周期数目。40-60分贝属于我们正常的交谈声音。其中汽车噪音介乎80-100分贝，以一辆汽车发出90分贝的噪音为例，在一百米处，仍然可以听到81分贝的噪音（以上标准会因环境的差异有所不同
模拟输入: 模拟输入是指输入模拟信号（模拟量）
保正: 那时候家庭人口比较多，平均一户五个人，五百户人家大约两千五百人，那时候没有区的概念，就是县，大县设县令，小县设县长，保正大体上相当于现在乡长的职位。后世沿其法，因泛称保长等为保正。每十大保（也就是五百户）设都保。都保的领导叫都保正，还有一个副保正
学术: 学术，是指系统专门的学问，泛指高等教育和研究，是对存在物及其规律的学科化。学术，是指系统专门的学问，泛指高等教育和研究，是对存在物及其规律的学科化。“学术，是指对于方法的学习
电桥: 可以通过调节各已知电阻的值使G中无电流通过，则电桥平衡，未知电阻R2=R1·R4/R3。电桥，是用比较法测量各种量（如电阻、电容、电感等）的仪器。各支路称为电桥的“臂”。最简单的是由四个支路组成的电路，各支路称为电桥的“臂”
KTV: KTV，从狭义的理解为：提供卡拉ok影音设备与视唱空间的场所。KTV，从狭义的理解为：提供卡拉ok影音设备与视唱空间的场所。广义理解为集合卡拉ok、慢摇、HI房、背景音乐并提供酒水服务的主营业为夜间的娱乐场。ktv是Karaoke Television
LED灯: LED是英文 light emitting diode （发光二极管）的缩写，它的基本结构是一块电致发光的半导体材料芯片，用银胶或白胶固化到支架上，然后用银线或金线连接芯片和电路板，四周用环氧树脂密封，起到保护内部芯线的作用，最后安装外壳，所以 LED 灯的抗震性能好。置于一个有引线的架子上，然后四周用环氧树脂密封，起到保护内部芯线的作用，所以LED的抗震性能好。LED ，英文light emitting diode的简称，又称发光二极管。它的基本结构是一块电致发光的半导体材料，是一种固态的半导体器件，它可以直接把电转化为光
壁灯: 壁灯（wall lamp）是安装在室内墙壁上的辅助照明装饰灯具，一般多配用乳白色的玻璃灯罩。床头壁灯大多数都是装在床头的左上方，灯头可万向转动，光束集中，便于阅读。壁灯多装于阳台、楼梯、走廊过道以及卧室、适宜作长明灯。镜前壁灯多装饰在盥洗间镜子附近使用。变色壁灯多用于节日、喜庆之时采用
系统模块: 调光模块的基本原理是由微处理器（CPU）控制可控硅的开启角大小，从而控制输出电压的平均幅值去调节光源的亮度
汪晗: 主持基金： 国家社会科学基金：民族地区主体功能区国土空间管制下土地发展权受限与空间转移研究 广西自然科学基金：城市用地扩张过程中土地类型转换碳储碳排放效应的管控研究——以广西南宁市城乡交错区为例
插口: 插口，汉语词汇
接收数据: 在数据通信网中，按一种链路协议的技术要求连接两个或多个数据站的电信设施，称为数据链路，简称数据链
板块: 正因为板块运动与上述地质现象的对应性，板块构造学说可用以解释世界火山和地震带的形成、矿产的分布和各地貌的形成等。板块构造学说认为，岩石圈并非整体一块，而是分裂成许多块，这些大块岩石称为板块。板块是板块构造学说所提出来的概念。板块之中还有次一级的小板块
模块化: 模块化是指解决一个复杂问题时自顶向下逐层把系统划分成若干模块的过程，有多种属性，分别反映其内部特性。另外一种途径是基于经典描述逻辑语义，但限制对外部符号的使用以保证各模块可安全的合并。模块化是一种处理复杂系统分解成为更好的可管理模块的方式
加密: 加密，是以某种特殊的算法改变原有的信息数据，使得未授权的用户即使获得了已加密的信息，但因不知解密的方法，仍然无法了解信息的内容。在航空学中，指利用航空摄影像片上已知的少数控制点，通过对像片测量和计算的方法在像对或整条航摄带上增加控制点的作业
一笔画成: 《一笔画成》是个简单又考验平面逻辑思维的游戏，游戏规则简单，选择好起点开始拉线，沿着所给出的图形内容，不重复覆盖好每一条边即可，需要注意的是，游戏过程中不能松手，不然还得再重新画过。一笔画成，是一款热门的游戏，游戏大小：2.44MB
红外线传输: 中红外线，波长为(2.5-3)～(25-40)μm之间
光敏电阻: 这是由于光照产生的载流子都参与导电，在外加电场的作用下作漂移运动，电子奔向电源的正极，空穴奔向电源的负极，从而使光敏电阻器的阻值迅速下降。光敏电阻又称光导管，常用的制作材料为硫化镉，另外还有硒、硫化铝、硫化铅和硫化铋等材料。光敏电阻，是一种特殊的电阻，简称光电阻，又名光导管。它的电阻和光线的强弱有直接关系
逗比: 简单的说，就是说某个人很逗，有点犯二犯傻，有点可爱。（原词解释是挺逗的傻逼，但是一般来说，开玩笑用逗比，比骂人用的次数要多很多，所以理解为挺逗的二比，因为谁都会偶尔犯二，二的可爱。简单的说，就是说某个人很逗，有点犯二犯傻，有点可爱。如果对陌生人说，指别人是傻叉的意思多一点。如果是好朋友之间说，那就是调侃和玩笑的意思多一点
丢手绢: 蹲着的小朋友开始唱歌“丢，丢，丢手绢，轻轻的放在小朋友的后面大家不要告诉他” 歌曲结束之前丢手绢的小朋友必须把手绢放在某个小朋友B的身后，然后快速回到自己原本的位置。如果被丢者发现后，可手执手绢追赶，丢手绢者被赶上则认输，罚出节目。如果被丢者没察觉，丢手绢者跑一圈回到其背后，被丢手绢者认输，前者坐其位子。丢手绢，又叫丢手帕，中国传统的民间儿童游戏
人眼: 与其它哺乳动物的眼睛共通，人眼的非成像光敏神经节细胞在视网膜接收到光的讯号强弱、荷尔蒙的褪黑激素和生理时钟 诱导的规画和抑制，会影响到和调整瞳孔的大小。在视网膜的杆细胞和锥细胞拥有包括色彩分化和深度意识的光感和视觉。作为意识感觉器官，眼睛拥有视觉。人眼是对光起反应，并有多种用途的一种器官。人类的眼睛可分辨约一千万颜色
过路人: ，收录于1992年EP专辑《无悔无憾》中
智能手机: 智能手机，是指像个人电脑一样，具有独立的操作系统，独立的运行空间，可以由用户自行安装软件、游戏、导航等第三方服务商提供的程序，并可以通过移动通讯网络来实现无线网络接入手机类型的总称。智能手机 的使用范围已经布满全世界，但不是人人都知晓与使用因为智能手机具有优秀的操作系统、可自由安装各类软件（仅安卓系统）、完全大屏的全触屏式操作感这三大特性，所以完全终结了前几年的键盘式手机。其中Google(谷歌)、 苹果、三星、诺基亚、HTC（宏达电） 这五大品牌在全世界最广为皆知，而小米（Mi）、华为（HUAWEI）、魅族(MEIZU)、联想（Lenovo）、为吾（wewa）、中兴（ZTE）、酷派（Coolpad）、一加手机（oneplus）、金立（GIONEE）、天宇（天语，K-Touch）等品牌在中国备受关注。极端条件测试表明，智能手机不仅仅会在酷暑下因过热而自动关闭，也会因酷寒而自动关闭
泊车: 外来语，即停车，存放车辆。由粤语和英语混合而成
原作: 漫画、小说、游戏作品在制作成动画之后，漫画家、小说或脚本作者以及游戏原案即成为该动画的作品的原作。日本的TV动画通常是由漫画，小说或者游戏。它指的就是原漫画/小说的作者
台灯: 台灯的光亮照射范围相对比较小和集中，因而不会影响到整个房间的光线，作用局限在台灯周围，便于阅读、学习，节省能源。它一般分为两种，一种是立柱式的，一种是有夹子的。它的工作原理主要是把灯光集中在一小块区域内，集中光线，便于工作和学习
GHT: GHT美国环球汇金简称（GHT）。其他　　1.杠杆倍数：1：100的杠杆 　　2.最小交易单位：0.1手 　　3.开户行：汇丰银行 　　4.开户要求：最低500美金
呼吸灯: 灯光在微电脑的控制之下完成由亮到暗的逐渐变化，感觉好像是人在呼吸。而越来越多的笔记本或者一些电子产品都加入“呼吸灯”的设计。呼吸灯是指灯光在微电脑控制之下完成由亮到暗的逐渐变化，感觉像是在呼吸
遥控器: 遥控器是一种无线发射装置，通过现代的数字编码技术，将按键信息进行编码，通过红外线二极管发射光波，光波经接收机的红外线接收器将收到的红外信号转变成电信号，进处理器进行解码，解调出相应的指令来达到控制机顶盒等设备完成所需的操作要求。遥控器的发射部分的主要元件为红外发光二极管。现代的遥控器，主要是由集成电路电板和用来产生不同讯息的按钮所组成。用于   客车(大巴、中巴）遥控开、关车门，避免   驾驶员每次都需要上车开门的烦恼。它实际上是一只特殊的发光   二极管，由于其内部材料不同于普通发光二极管，因而在其两端施加一定电压时，它便发出的是   红外线而不是可见光
主播: 而主播要做的工作更多，策划、编辑、采访、制作、导播、主持等一系列工作大都是由主播负责，不是全部但也会参与。而主播要做的工作更多，策划、编辑、采访、制作、导播、主持等一系列工作大都是由主播负责，不是全部但也会参与。主播不同于现在的主持人，主持人只是单纯的做主持工作，将一段一段的节目串联起来。就国内来讲，读报类节目主持人更趋近于主播的定义
阈值: 阈的意思是界限，故阈值又叫临界值，是指一个效应能够产生的最低值或最高值。当一种行为更难于释放时，就是阈值提高了。当一种行为更容易释放时，就是阈值下降了
光敏传感器: 光敏传感器是最常见的传感器之一，它的种类繁多，主要有：光电管、光电倍增管、光敏电阻、光敏三极管、太阳能电池、红外线传感器、紫外线传感器、光纤式光电传感器、色彩传感器、CCD和CMOS图像传感器等。光敏传感器是把光信号变成电信号的一种传感器。光传感器是目前产量最多、应用最广的传感器之一，它在自动控制和非电量电测技术中占有非常重要的地位
真心话大冒险: 《真心话大冒险》是一款卡牌类游戏。由选定的一方选择"真心话"还是"大冒险"，选择真心话，则由胜方随意问输者问题，输者必须全部如实回答。如果有很多人，可以抽牌，通常来说抽中大鬼的那位就要选择真心话还是大冒险
巴卢: 巴卢，男，巴西人，出生于1985年2月22日，足球运动员，现效力于马里迪莫球队
扩展接口: 扩展接口是主板上用于连接各种外部设备的接口。而且，通过扩展接口还能实现电脑间的互连
事件: 事件，定义为：比较重大,对一定的人群会产生一定影响的事情。事件一般是指历史上或社会上已经发生的产生相当影响的事情。它的发生是受多重因素激发而产生的
低头族: 低头族，（英文名：Phubbing单词由澳大利亚麦肯和Macquarie大辞典联手精心杜撰而来，形容那些只顾低头看手机而冷落面前的亲友的“低头族”）是指如今无论何时何地，人们都作“低头看屏幕”状，有的看手机，有的掏出平板电脑或笔记本电脑上网、玩游戏、看视频，想通过盯住屏幕的方式，把零碎的时间填满的人。他们低着头是一种共同的特征，他们的视线和智能手机，相互交感直至难分难解。2014年12月，网友称自己半夜在台北车站遇到“无头阿伯”，吓得他以为撞鬼
12月2日: 12月2日在公历平年一年中的第336天，在公历闰年一年中的第337天。1869年——美国西雅图市建立。1992年这一天西藏邦达机场破土动工
化工: 在现代生活中，几乎随时随地都离不开化工产品，从衣、食、住、行等物质生活到文化艺术、娱乐等精神生活，都需要化工产品为之服务。在现代生活中，几乎随时随地都离不开化工产品，从衣、食、住、行等物质生活到文化艺术、娱乐等精神生活，都需要化工产品为之服务。有些化工产品在人类发展历史中，起着划时代的重要作用。化工，即化学工业，普及到人类生活的方方面面。它们的生产和应用，甚至代表着人类文明的一定历史阶段
国际标准: 国际标准是指国际标准化组织（ISO）、国际电工委员会（IEC）和国际电信联盟（ITU）制定的标准，以及国际标准化组织确认并公布的其他国际组织制定的标准
R4: DS 系列主机而开发的 Slot-1 ，同原装卡带同样大小同样厚度，具有烧录游戏、自制程序和多媒体功能，是 DS 用户不可缺少的外围设备
报警: 报警指因使国家、公共利益、本人或者他人的人身、财产和其他权利免受损失而通过电话、网络、信件等方式向警方报告危急情况或发出危急信号。清李渔《奈何天·攒羊》：“自从受事以来，探卒时时报警，饥军日日呼庚。”曹禺等《胆剑篇》第四幕：“我奉了文种大夫之命，在城楼上正装设报警大鼓
自习室: 自习室是专门为学生用来自主学习的教室。固定自习室：从不安排课，专为全校学生自习使用的教师。3 - 与此相关的有：　　专用自习室：为某一班级、某一专业的学生专用的自习室
盆栽: 盆栽系由中国传统的园林艺术演变而来。至于对观赏植物的栽培，起源于古代园林造景，以摹仿自然山水景色营造园林。夏有瑶参、商有鹿台、周有灵台
口罩: 口罩是一种卫生用品，一般指戴在口鼻部位用于过滤进入口鼻的空气，以达到阻挡有害的气体、气味、飞沫进出佩戴者口鼻的用具，以纱布或纸等制成。口罩的外层往往积聚着很多外界空气中的灰尘、细菌等污物，平时最好多备几只口罩，以便替换使用，应每日换洗一次。口罩可分为空气过滤式口罩和供气式口罩，世界上最先使用口罩的是中国
安全原理: 《安全原理》是2005年化学工业出版社出版的图书，作者是隋鹏程，陈宝智，隋旭
安全性分析: 网站安全性分析即指，分析者论述威胁网站安全的原因，提出在建立网站时应考虑的安全性目标以及防范手段。是企业经营分析的重要内容之一。企业的财务风险主要来自于负债
电灯: 电灯，即用电作能源的人造照明用具，能将电转化为光，大大推动了人类文明的进步。电灯泡外壳用玻璃制成，把灯丝保持在真空，或低压的惰性气体之下，作用是防止灯丝在高温之下氧化。它只有7～8％的电能变成可见光，90％以上的电能转化成了热，电灯的发光效率很低，然而，它却是电灯世界的开路先锋。1809年，英国皇家研究院教授汉弗莱·戴维爵士（法拉第的老师）用2000节电池和两根炭棒，制成世界上第一盏弧光灯。自电灯发明以来，它大大推动了人类的发展
身影: 《身影》是大型古装电视剧《皇太子秘史》的片尾曲，由尤小刚作词、张宏光作曲、容祖儿演唱。” 唐·薛能 《秋日将离滑台酬所知》诗之二：“灯涩秋光静不眠，叶声身影客窗前。《身影》是大型古装电视剧《皇太子秘史》的片尾曲，由尤小刚作词、张宏光作曲、容祖儿演唱
陪你: 《陪你》是JS组合作词并编曲、唐禹哲演唱的一首歌曲，收录于专辑《D一秒》中
学籍: 学籍是指一个学生属于某学校的一种法律上的身份或者资格，登记学生姓名的册子，专指作为某校学生的资格。2013年9月1日起，全国已经初步建立了中小学籍的信息管理系统
Pedometer: Pedometer是一款理财购物类软件，运行环境是支持Android 1.6
晚会: 晚会，晚上的集会(以演出文艺节目为主)。晚会分类有表演晚会，歌舞晚会，庆祝晚会，春节联欢晚会等等
超声波测距: 利用超声波检测往往比较迅速、方便、计算简单、易于做到实时控制，并且在测量精度方面能达到工业实用的要求，因此在移动机器人研制上也得到了广泛的应用。由于超声波指向性强，能量消耗缓慢，在介质中传播的距离较远，因而超声波经常用于距离的测量，如测距仪和物位测量仪等都可以通过超声波来实现
账号: 账号的账多数跟金钱有关。为了确保账号的安全，应经常配上密码与其共同使用
显示原理: 显示原理降低了机制设计问题的复杂程度，大大推动了拍卖理论的发展。显示原理是经济博弈理论中的重要工具，任何贝叶斯博弈的任何贝叶斯纳什均衡，都可以重新表示为一个激励相容的直接机制
详情: 详情，指审察实情，详细情形。’”《二刻拍案惊奇》卷三五：“这不是小人自家走进去住在里头的，须怪小人不得，望爷爷详情。鲁迅 《且介亭杂文·忆韦素园君》：“他不但写信给我，叙述着详情，还作文登在杂志上剖白
水域: 《水域》是日本漫画家漆原友纪创作的连载漫画。如国家沿海有属于它的水域或海域，又如港口管辖的水体范围等。水域，是指江河、湖泊、运河、渠道、水库、水塘及其管理范围
idea: IDEA 全称IntelliJ IDEA，是java语言开发的集成环境，IntelliJ在业界被公认为最好的java开发工具之一，尤其在智能代码助手、代码自动提示、重构、J2EE支持、Ant、JUnit、CVS整合、代码审查、 创新的GUI设计等方面的功能可以说是超常的。IDEA是JetBrains公司的产品，这家公司总部位于捷克共和国的首都布拉格，开发人员以严谨著称的东欧程序员为主。IDEA所属现代词，指的是想法, 念头, 意见, 主意, 思想, 观念, 概念
自行车: 越来越多的人将自行车作为健身器材用来骑行锻炼、自行车出游。在中国大陆、香港、澳门、台湾、新加坡，通常称其为“自行车”或“脚踏车”。人骑上车后，以脚踩踏板为动力，是绿色环保的交通工具。现在自行车遍及世界各地，进入家家户户，是人们最常见的交通工具。英文bicycle或bike的bi意指二，而cycle意指轮
串口通信: 串行接口是一种可以将接受来自CPU的并行数据字符转换为连续的串行数据流发送出去，同时可将接受的串行数据流转换为并行的数据字符供给CPU的器件。串口通信（Serial Communications）的概念非常简单，串口按位（bit）发送和接收字节。串行接口是一种可以将接受来自CPU的并行数据字符转换为连续的串行数据流发送出去，同时可将接受的串行数据流转换为并行的数据字符供给CPU的器件
马船: 马船又名马快船，是明初的大型快速水战与运输兼用船，《明会典》注明，“以备水军进征之用”，明人罗懋登的《三宝太监西洋记》中，称其长三十七丈，宽十五丈，有八桅，其体型尺度与《瀛涯胜览》中提到的中型宝船一致。由此揣测这种船舶编列在船队之中，主要任务可能是运载船员所携带的马匹以及下西洋时输出或输入的大量物品。在《续文献通考》卷五十三“职官”三中，曾提到“马船”专司供送官物
弹性体: 弹性体只是在弱应力下形变显著，应力松弛后能迅速恢复到接近原有状态和尺寸的高分子材料[1]。弹性体：泛指在除去外力后能恢复原状的材料，然而具有弹性的材料并不一定是弹性体。弹性体是一种性能独特的人造热可塑性弹性体，具有非常广泛的用途。所属学科：水利科技（一级学科）
绿光: 发生该现象需要具备很多条件，包括能见度高、海面附近没有云等
商店: 商店，一般是指商品开架陈列，顾客自我服务，货款一次结算，以经营生鲜食品、日杂用品为主的经营商。商店通常指独立经营、独立核算的基层商业企业，包括批发商店和零售商店。中国的零售商店,主要有五种类型:综合商店、联合商店、专业商店、大百货商店和商场
类型: 在上面两种方法中，类型被认为是一系列满足确定约束条件的元素，更抽象的方式可以把一个类型当作规定一个约束条件，如果我们规定的约束条件越好，相对应的被定义元素的集合就越精密，所以逻辑公式（logical formulas）就成为描述类型特征的最合适工具
理光: 市村清在1936年成立理化学研究所，研究所主要研究理研阳画感光纸，1963年正式易名为理光，并在同年成立香港分公司。理光株式会社前身是市井清在1936年成立的理化学研究所，主要研究理研阳画感光纸。理光株式会社（株式会社リコー，Ricoh Company, Ltd.）是日本著名的办公设备及光学机器制造商、世界五百强企业。1963年正式易名为理光，并在同年成立香港分公司
美团外卖: 美团外卖是美团网旗下的网上订餐平台，于2013年11月正式上线，已覆盖北京、上海、广州、 天津、西安、沈阳、厦门、宁波、武汉、昆明等城市。目前外卖的市场规模是不亚于团购市场的，美团外卖将快速扩张，未来三年投资10亿，预计复盖100个城市，并和各城市当地的外卖配送团队建立合作，实现以分钟为单位的即时配送。此外，美团外卖将不仅局限于早餐、午餐、晚餐和夜宵的外卖，还希望将复盖面扩展至奶茶咖啡等各种品类
C接口: C接口是移动交换中心MSC与HLR间的接口。当建立呼叫时，MSC经此口从HLR中获取路由选择信息。C接口是移动交换中心MSC与HLR间的接口
盗贼: 释义：1、盗贼指偷窃和劫夺财物行为的人。按照他们的意愿改变事件，具备最大的优势才出击：这是盗贼们最拿手的。同时，盗贼还是网络游戏《魔兽世界》中十大职业之一，现更名为潜行者。与阴影为伴，精于逃离的艾泽拉斯的盗贼们最擅长在幕后行动。盗贼指偷窃和劫夺财物的行为
RTC: RTC是多种名词的缩写，如：实时时钟（Real-Time Clock）、美国资产重组托管公司（Resolution Trust Corporation）、 协作软件交付环境（IBM Rational Team Concert）、响应时间补偿（Response Time Compensation）、实时通讯（Real-time communications）、 雷达跟踪中心（Radar TrackingCentre）
红外遥控: 红外遥控是一种无线、非接触控制技术，具有抗干扰能力强，信息传输可靠，功耗低，成本低，易实现等显著优点，被诸多电子设备特别是家用电器广泛采用，并越来越多的应用到计算机和手机系统中。远程遥控技术又称为遥控技术，是指实现对被控目标的遥远控制，在工业控制、航空航天、家电领域应用广泛
人时: 人时，读音为rén shí，汉语词语，意思是指有关耕获的时令节气，也可以指历法
演唱: 以唱的方式来表演（歌曲、戏曲.歌剧等）
循环结构: 循环结构可以减少源程序重复书写的工作量，用来描述重复执行某段算法的问题，这是程序设计中最能发挥计算机特长的程序结构。while循环是先执行循环体后判断表达式，也就是说do。while 循环和for循环都是先判断表达式，后执行循环体
原理图: 原理图，顾名思义就是表示电路板上各器件之间连接原理的图表。由原理图延伸下去会涉及到PCB layout，也就是PCB布线，当然这种布线是基于原理图来做成的，通过对原理图的分析以及电路板其他条件的限制，设计者得以确定器件的位置以及电路板的层数等。原理图，顾名思义就是表示电路板上各器件之间连接原理的图表
很人: 很人是一个汉语词语，读音是hěn rén，是指执拗乖戾的人
酒吧: 酒吧最初源于美国西部大开发时期的西部酒馆，Bar一词到16世纪才有“卖饮料的柜台”这个义项，后又随着时代的发展演变为提供娱乐表演等服务的综合消费场所，约20世纪90年代传入我国。Bar多指娱乐休闲类的酒吧，提供现场的乐队或歌手、舞女表演。酒吧有很多类型和风格，既有最低档的“潜水吧”，也有为社会精英人士提供娱乐的优雅场所。酒吧是指提供啤酒、葡萄酒、洋酒、鸡尾酒等酒精类饮料的消费场所。经过数百年的发展演变，各种崇尚现代文明，追求高品位生活，健康优雅的“酒吧”正悄然走进人们的休闲生活，同时也在现代城市中形成一道亮丽独特的文化景观
小鸟: 小鸟是由北京天寰新宇国际传媒有限公司于2010年4月30日发行在《朴文哲》专辑的歌曲。后来看到泰戈尔的《飞鸟集》，起首一句就是“夏天的飞鸟，飞到我的窗前唱歌，又飞去了。他和数十个女人有过关系、留下了14个孩子
福利: 这些奖励作为企业成员福利的一部分，奖给职工个人或者员工小组。这些奖励作为企业成员福利的一部分，奖给职工个人或者员工小组。从管理层的角度看，福利可对以下若干战略目标作出贡献：协助吸引员工。由于这一原因，相对于等量的现金支付，福利在某种意义上来说，对员工就具有更大的价值。与员工的收人不同，福利一般不需纳税
出门之前: 《出门之前》是2013年9月新星出版社出版的图书，作者筒井赖子。而林明子典雅温柔的画风把孩子的每个神态变化和细微表情表现得分外动人。最后，沐浴着温暖的阳光，一家人出门野餐喽
电路连接: 《电路连接》是一款休闲益智游戏，游戏目标是按照正确的方式将所有电路全部接通
体积: 一件固体物件的体积是一个数值用以形容该物件在三维空间所占有的空间。体积，体积，或称容量、容积，是物件占有多少空间的量。一维空间物件（如线）及二维空间物件（如正方形）在三维空间中都是零体积的
文本文档: 文本文档是以TXT后缀名的文件，在windows页面重点及鼠标右键-〉新建-〉在下拉子菜单中有文本文档一项。文本文档是以TXT后缀名的文件，最常见的一种文件格式，主要存文本信息
内环境: 此外，内环境还是细胞生活与活动的地方。细胞代谢所需要的氧气和各种营养物质只能从内环境中摄取，而细胞代谢产生的二氧化碳和代谢终末产物也需要直接排到细胞外液中，然后通过血液循环运输，由呼吸和排泄器官排出体外。此外，内环境还是细胞生活与活动的地方。细胞代谢所需要的   氧气和各种营养物质只能从内环境中摄取，而细胞代谢产生的   二氧化碳和代谢终末产物也需要直接排到内环境中，然后通过血液循环运输，由呼吸和排泄器官排出体外。多细胞生物，细胞在体内直接所处的环境即   细胞外液，称之为内环境
液晶模块: 液晶模块简单点说就是LCD屏+LED背光板+PCB板+铁框。液晶模块简单点说就是屏+背光板+PCB板+铁框。电力终端、仪器仪表等的显示部件就是液晶模块，其地位相当于CRT中的显像管
陀螺: 中国是陀螺的老家。陀螺或旋转陀螺是一种玩具。陀螺也作陀罗，闽南语称作“干乐”，英文称之为“spinning top”，日本语中以“独乐”表示，称为“KOMA”
叫醒: 叫醒，读音jiào xǐng，是汉语词汇，解释为唤醒
代理权: 代理权是能够据之进行代理并使行为的效力直接归属于被代理人的权限。代理制度的发展是建立在社会商品经济发展的突飞猛进，势必要在经济活动中更加明确代理权方面一些问题。代理权是代理制度的核心内容
单片机原理: 它是一种在线式实时控制计算机，在线式就是现场控制，需要的是有较强的抗干扰能力，较低的成本，这也是和离线式计算机（比如家用PC）的主要区别
许多灯: 《许多灯》，诗集，曹东著，2009年6月重庆大学出版社出版。该书2009年6月重庆大学出版社出版
CSS: CSS 能够对网页中元素位置的排版进行像素级精确控制，支持几乎所有的字体字号样式，拥有对网页对象和模型样式编辑的能力。换而言之，CSS就是描述HTML元素的规则。使用CSS样式可以控制许多仅使用HTML无法控制的属性
电子密码锁: 电子密码锁是一种通过密码输入来控制电路或是芯片工作(访问控制系统),从而控制机械开关的闭合,完成开锁、闭锁任务的电子产品。出门时无需其他操作，只需一次的把手动作，可机械的开启门，所以遇到火灾等应急状况下也迅速，安全的开启门。在室内如果温度达到75°左右，将会发出强力的报警音，同时锁会自动开启
权限: 权限是指为了保证职责的有效履行，任职者必须具备的，对某事项进行决策的范围和程度。例如，具有批准预算外5000元以内的礼品费支出的权限。权限是现代词，是一个专有名词，指的是职能权利范围在法律规定的权限内
生命体征: 当心功能不全、休克、高热、严重的贫血和疼痛、甲状腺危象、心肌炎，以及阿托品等药物中毒时，心率和脉搏显著加快。当颅内压增高、完全性房室传导阻滞时，脉搏减慢。它们是维持机体正常活动的支柱，缺一不可，不论哪项异常也会导致严重或致命的疾病，同时某些疾病也可导致这四大体征的变化或恶化
剧毒: 剧毒化学品是指，按照国务院安全生产监督管理部门会同国务院公安、环保、卫生、质检、交通部门确定并公布的剧毒化学品目录中的化学品。一般是具有非常剧烈毒性危害的化学品，包括人工合成的化学品及其混合物（含农药）和天然毒素
下位机: 下位机是直接控制设备获取设备状况的计算机，一般是PLC/单片机之类的
幻彩: 它们滚落、滑动、散开并绽放，以此大胆醒目的方式向久负盛名的幻彩流星粉珠致敬。幻彩流星所有的“光线”专长集中于能漫射光线的底妆，蕴含具有修正及完善效果的神奇粉珠，来自法国娇兰。独特而别致，它们能在夏日的阳光下成就完美无瑕的幻想
偏差值: 日本是春季招生，每年冬季进行全国高中毕业生统一考试，各大学在录取学生时，常常用这次考试的偏差值评价学生的学习能力，并且作为录取的重要标准（实际上常常是唯一标准）。偏差值与个人分数无关，反映的是每个人在所有考生中的水准顺位。在日本，偏差值被看做学习水平的正确反映，而偏差值也就理所当然的成为了评价学习能力的标准。偏差值反映的是每个人在所有考生中的水准顺位。因此引发考生不满和舆论批评，同时也导致高中教育出现只重分数，不看操行的倾向
锡焊: 锡焊是利用低熔点的金属焊料加热熔化后，渗入并充填金属件连接处间隙的焊接方法。锡焊，是利用低熔点的金属焊料加热熔化后，渗入并充填金属件连接处间隙的焊接方法。但是遵循基本的原则，学习前人积累的经验，运用正确的方法，可以事半功倍地掌握操作技术
汽车: 我国国家最新标准《汽车和挂车类型的术语和定义》(GB/T 3730．1—2001)中对汽车有如下定义：由动力驱动，具有4个或4个以上车轮的非轨道承载的车辆，主要用于：载运人员和（或）货物。汽车原指以可燃气体作动力的运输车辆，也指有自身装备动力驱动的车辆。当时和戴姆勒在同一工厂的本茨，也在研究汽车。美国人亨利·福特首先大量生产平价汽车，是使汽车得以普及化的人。2016年 15晚会发布二号热点投诉：汽车消费投诉量排名第二
斯登: stun，翻译成司登或者斯登
Arduino: 对Arduino的编程是利用 Arduino编程语言 (基于 Wiring)和Arduino开发环境(基于 Processing)来实现的。对Arduino的编程是利用 Arduino编程语言 (基于 Wiring)和Arduino开发环境(基于 Processing)来实现的。Arduino是一款便捷灵活、方便上手的开源电子原型平台，包含硬件(各种型号的Arduino板)和软件(Arduino IDE)。另外一个则是Arduino IDE，你的计算机中的程序开发环境。它构建于开放原始码simple I/O介面版，并且具有使用类似Java、C语言的Processing/Wiring开发环境
作者: 在苏联、法国、联邦德国、西班牙等国的版权法中，作者指通过自己的独立构思、运用自己的技巧与方法，直接从事文学、艺术创作活动，并产生出体现创作者个人特性的作品的自然人， 其中包括小说家、诗人、散文作家、剧作家、作曲家、歌词作家、记者、画家、书法家、雕刻家、工艺品设计师、 建筑设计师、 摄影家、翻译家、计算机程序编制者等。作者一般指文学、艺术和科学作品的创作者，有时也指某种理论的创始人，或某一事件的组织者或策划者。美、日等国的版权法也承认法人为作者
智能算法: 在工程实践中，经常会接触到一些比较“新颖”的算法或理论，比如模拟退火，遗传算法，禁忌搜索，神经网络等。从自然界得到启迪，模仿其结构进行发明创造，这就是仿生学。另一方面，我们还可以利用仿生原理进行设计(包括设计算法)，这就是智能算法的思想
曲子: 2、相对于“歌”而言，音乐中常用“曲”或“曲子”表示非歌曲形式的音乐作品。城镇集市中广泛用于填词的民间常用曲调。一般来自经过长期流传、选择加工的民间歌曲
常琳: 常琳，中国人名，常见有足球运动员常琳、西安科技大学副教授常琳等。出生于大连、成长于大连，但常琳这个名字对于很多滨城球迷来说，还是有些陌生。几次球队转会，多次实战经历，终于磨砺除了坚韧的他
无线电: 无线电是指在所有自由空间（包括空气和真空）传播的电磁波，是其中的一个有限频带，上限频率在300GHz（吉赫兹），下限频率较不统一， 在各种射频规范书， 常见的有3KHz~300GHz（ITU－国际电信联盟规定），9KHz~300GHz，10KHz~300GHz。在天文学上，无线电波被称为射电波，简称射电
整数: 则正整数、零与负整数构成整数系。（整数是表示物体个数的数，0表示有0个物体）整数是人类能够掌握的最基本的数学工具。在整数系中，自然数为0和正整数的统称，称0为零，称-1、-2、-3、。（整数是表示物体个数的数，0表示有0个物体）整数是人类能够掌握的最基本的数学工具。一个给定的整数n可以是负数，非负数，零（n=0）或正数
梁沛: 梁沛，男，博士，中国农业大学农学与生物技术学院昆虫学系副教授
广场舞: 广场舞是近几年流行起来的，所以又叫现代舞，是现代都市人们健身舞，盛行于川渝地区，一般广场舞很多都是结合现代流行因素进行编舞，所以和现代生活息息相关。广场舞是人民群众创造的舞蹈，是专属于人民群众的舞蹈，因为民族的不同，地域的不同，群体的不同所以广场舞的舞蹈形式也不同。广场舞是近几年流行起来的，所以又叫现代舞，是现代都市人们健身舞，一般广场舞很多都是结合现代流行因素进行编舞，所以和现代生活息息相关
人体: 人体，从思想上来说，是会受到社会环境，文化、传统与及周围气氛的制约，并且会产生从想象得出来成果的生物实体（P.fargier）。对于一般生物学或医学而言，人体除包括以上各部分，还包括呼吸、心血管、神经系统和其他内脏，而每部分皆由细胞构成。人体由无机物和有机物构成。人体即一个人的身体，主要组成部分有头、颈、躯干、双臂及双腿
感受器: 感受器是动物体表、体腔或组织内能接受内、外环境刺激，并将之转换成神经冲动过程的结构。感受器是动物体表、体腔或组织内能接受内、外环境刺激，并将之转换成神经过程的结构。外感受器包括：光感受器、听感受器、味感受器、嗅感觉器和分布在体表、皮肤及粘膜的其他各类感受器
社区: 尽管社会学家对社区下的定义各不相同，在构成社区的基本要素上认识还是基本一致的，普遍认为一个社区应该包括一定数量的人口、一定范围的地域、一定规模的设施、一定特征的文化、一定类型的组织。社区是若干社会群体或社会组织聚集在某一个领域里所形成的一个生活上相互关联的大集体，是社会有机体最基本的内容，是宏观社会的缩影。社区就是这样一个“聚居在一定地域范围内的人们所组成的社会生活共同体”
充电: 其原理是让直流电从放电相反的方向通过，以使蓄电池中活性物质恢复作用。现在，又有了引申义比如学习，工作等。“充电”是给蓄电池等设备补充电量的过程。如打印机等设备的充电行为
路人: 《路人》是由江美琪演唱的歌曲，洪瑞业作词，林俊杰作曲，出自专辑《爱哭鬼》。由林俊杰作曲，洪瑞业作词，收录于专辑《爱哭鬼》中
改装: 改装（gǎi zhuāng），词语，有改变设备原来的结构、装置。retrofit 定义：为改进装备性能、扩大功能、提高可靠性安全因素，或适应任务要求而对原装备加以更改、改进或加装的工程项目。英文名称：modification
四旋翼: 四旋翼飞行器由于能够垂直起降，自由悬停，且机身轻便易操控，可适应于各种速度及各种飞行剖面航路的飞行状况，这些优势决定了它是一种军民两用的高科技设备。Seraphi集成易作、易维护的稳定设计，在出厂前已经设置并调试所有的飞行参数及功能，具有免安装、免调试的快速飞行模式。Seraphi 携带方便，可以搭配GoPro或者其它微型相机录制空中视频。四旋翼飞行器也称为四旋翼直升机，是一种有4个螺旋桨且螺旋桨呈十字形交叉的飞行器
逃跑计划乐队: 逃跑计划乐队的前身是孔雀乐队，成立于2004年底，直到2007年夏天贝司手小刚的加入，乐队得以正式确立，并且乐队的音乐风格较之前也有所改变，以Indie pop（独立流行）为主，其间也融入了New wave（新浪潮）。逃跑计划乐队的前身是孔雀乐队，成立于2004年底，直到2007年夏天贝司手小刚的加入，乐队得以正式确立，并且乐队的音乐风格较之前也有所改变，以Indie pop（独立流行）为主，其间也融入了New wave（新浪潮）。逃跑计划乐队，又称Escape Plan乐队，中国流行摇滚乐队，乐队由毛川、马晓东、刚昂、红桃组成
缺少: 缺少，指短缺。那一个就敢欺负着你
镜片: 其折射率比树脂镜片高，因此在同样度数情况下，玻璃镜片要比树脂镜片薄。其折射率比树脂镜片高，因此在同样度数情况下，玻璃镜片要比树脂镜片薄。玻璃镜片的透光率和机械化学性能都比较好，有恒定的折射率、理化性能稳定。玻璃镜片的主要原料是光学玻璃
连接器: 就泛指而言，连接器所接通的不仅仅限于电流，在光电子技术迅猛发展的今天，光纤系统中，传递信号的载体是光，玻璃和塑料代替了普通电路中的导线，但是光信号通路中也使用连接器，它们的作用与电路连接器相同。MFC 表头文件包含 # pragma 指述 (特别的编译器指令)，它将叙述必需的程序模式文件。当一些较小的程序从源程序中被创建出来的时候，一个逐渐增加的联结选择项将运行时间减到最少。即连接两个有源器件的器件，传输电流或信号。连接器，即CONNECTOR
水库: 水库，一般的解释为“拦洪蓄水和调节水流的水利工程建筑物，可以利用来灌溉、发电、防洪和养鱼。一般的形成方法是在河流的中上流建造堤坝，河水把河谷淹没后便形成水库。水库是指人造的湖泊，而规模较小的则称为水塘、塘坝和蓄水池。兴建之前，将被水淹地带的民居和古迹需要被移到其他地方。不过也有的水库是建于海上的，例如香港的船湾淡水湖
盆花: 盆花含盆景、水培、草花、观叶观果观花等所有盆栽花卉。盆花是指以盆栽形式存在的花卉。可以是真花也可以是仿真花
体感控制: 体感控制，在于人们可以很直接地使用肢体动作，与周边的装置或环境互动，而无需使用任何复杂的控制设备，便可让人们身历其境地与内容做互动
噩梦: 噩梦是指做内容恐怖的梦，并引起焦虑恐惧为主要表现的睡眠障碍。恶梦很容易被叫醒或被梦境惊醒,醒后很快意识清醒，能清醒地回忆刚才所做的梦，往往需稍待一段时间才能入睡。噩梦是指做内容恐怖的梦，并引起焦虑恐惧为主要表现的睡眠障碍
造福: 造福，汉语词语，[bring benefit to] ，指给人带来幸福，造福人类
显示器: 根据制造材料的不同，可分为：阴极射线管显示器（CRT），等离子显示器PDP，液晶显示器LCD等等。它是一种将一定的电子文件通过特定的传输设备显示到屏幕上再反射到人眼的显示工具。显示器是属于电脑的I/O设备，即输入输出设备。显示器（display）通常也被称为监视器
参数: 如果我们引入一个或一些另外的变量来描述自变量与因变量的变化，引入的变量本来并不是当前问题必须研究的变量，我们把这样的变量叫做参变量或参数。我们在研究当前问题的时候，关心某几个变量的变化以及它们之间的相互关系，其中有一个或一些叫自变量，另一个或另一些叫因变量。英文名：Parameter
1月28日: 1月28日是阳历年的第28天，离一年的结束还有337天（闰年是338天）。1954年这一天，北京—莫斯科直达客车首次通车。2008年1月28日，国家游泳中心竣工
雾霾: 2014年2月，习近平在北京考察时指出：应对雾霾污染、改善空气质量的首要任务是控制PM2.5，要从压减燃煤、严格控车、调整产业、强化管理、联防联控、依法治理等方面采取重大举措，聚焦重点领域，严格指标考核，加强环境执法监管，认真进行责任追究。高密度人口的经济及社会活动必然会排放大量细颗粒物（PM2.5），一旦排放超过大气循环能力和承载度，细颗粒物浓度将持续积聚，此时如果受静稳天气等影响，极易出现大范围的雾霾。中国不少地区将雾并入霾一起作为灾害性天气现象进行预警预报，统称为“雾霾天气”。中国不少地区把阴霾天气现象并入雾一起作为灾害性天气预警预报。2016年11月，北京雾霾发现耐药菌：人类最后的抗生素对它束手无策
散射: 散射是被投射波照射的物体表面曲率较大甚至不光滑时，其二次辐射波在角域上按一定的规律作扩散分布的现象。如一束光通过稀释后的牛奶后为粉红色，而从侧面和上面看，是浅蓝色。散射是指由传播介质的不均匀性引起的光线向四周射去的现象
在医院: 这本书通过童趣的语言告诉孩子们在医院里的一些常识和一些行为规范
风力: 现代人们利用风力发电、发热等对风力进行利用，节能减排，保护环境。据测定，一台55千瓦的风力发电机组，当风速每秒为9.5米时，机组的输出功率为55千瓦。明田艺蘅《留青日札·鄢懋卿》：“以都御史经理东南盐课诸务，声势赫戾，睹记所未有此，每历淮扬诸大镇则餽索不下二三百万金，风力所加，甚于诏旨。风力，是指风的力量，即在任意风级上的某一定数，如5或7级
词条: 词条是搜狗百科所含内容的基础分割单位。有一个单一的主题，用于阐述一件事物、一个人物、或他们具备特定主题的组合。例如：“彩虹”、“泥石流”、“李世民”、"CSOL"等。词条可以是字、词，也可以由字、词等组成
github: GitHub 于 2008 年 4 月 10 日正式上线，除了 Git 代码仓库托管及基本的 Web 管理界面以外，还提供了订阅、讨论组、文本渲染、在线文件编辑器、协作图谱（报表）、代码片段分享（Gist）等功能。Git是一个分布式的版本控制系统，最初由Linus Torvalds编写，用作Linux内核代码的管理。Git同样可以被诸如Capistrano和Vlad the Deployer这样的部署工具所使用
.com: 国际化公司都会注册·com域名，当然也可以选择以·net/.org为结尾的国际域名。二是国内域名，又称为国内顶级域名（national top-level domainnames，简称nTLDs），即按照国家的不同分配不同后缀，这些域名即为该国的国内顶级域名。例如表示工商企业的·com，表示网络提供商的·net，表示非盈利组织的·org等。.com域名，国际最广泛流行的通用域名格式
电源管理: 电源管理技术也称做电源控制技术，它属于电力电子技术的范畴，是集电力变换，现代电子，网络组建，自动控制等多学科于一体的边缘交叉技术，现今已经广泛应用到工业，能源，交通，信息，航空，国防，教育，文化等诸多领域。通过降低组件闲置时的能耗，优秀的电源管理系统能够将电池寿命延长两倍或三倍。电源管理对于依赖电池电源的移动式设备至关重要。电源管理是指如何将电源有效分配给系统的不同组件
养生: 保养，是指遵循生命法则，通过适度运动，加之外在护理等手段，让身体机能及外在皮肤得以休养生息，恢复应有机能，这是养生的第一层面。现代意义的“养生”指的是根据人的生命过程规律主动进行物质与精神的身心养护活动。实质上，养生就是保养五脏，使生命得以绵长的意思。总之，养生就是保养生命的意思。所谓生，就是生命、生存、生长之意
电路图: 电路图是人们为研究、工程规划的需要，用物理电学标准化的符号绘制的一种表示各元器件组成及器件关系的原理布局图。电路图是人们为了研究和工程的需要，用约定的符号绘制的一种表示电路结构的图形。通过电路图可以知道实际电路的情况
警告信息: 警告信息是指某种物质向另外一种物质发送信息，以达到警告或者引人注意的目的（甚至是一种使接收这一信息的人紧张的信息）
马拉松: 马拉松（Marathon）长跑是国际上非常普及的长跑比赛项目，全程距离26英里385码，折合为42.195公里（也有说法为42.193公里）。全世界每年举行的马拉松比赛超过800个，大型的赛事通常有数以万计的参与者，多数人以健身休闲为目的。但国际田联（IAAF）为了刺激公路比赛的发展，决定从2004年1月1日开始，设立马拉松、竞走等公路比赛的世界纪录
一个都不能死: 2014年6月26日，虐心手游再度来袭，“一个都不能死”新版正式通过腾讯安卓应用商店应用宝独家首发。一个都不能死是一款好玩又有趣的敏捷的跑酷游戏，此款游戏规则简单，操作起来简单容易上手，玩家可以使用自己的武器对障碍物进行攻击，当然这个是有数量限制的，你要选择好恰当的时机。不要以为控制多个火柴人游戏的判定就会宽松些，反而，游戏的判定非常严格，就比flappy bird稍微强上那么一点点，火柴人起跳早了腿会碰到障碍，起跳晚了直接撞上去，而且数排的火柴人遇到障碍的时间都不一样，简直是令人发指
LED显示器: LED显示器（LED panel），是一种通过控制半导体发光二极管的显示方式，用来显示文字、图形、图像、动画、行情、视频、录像信号等各种信息的显示屏幕
警报器: 警报器指发放警报信号的器具。每当遇到外敌入侵、战事警报或是火灾，守兵便用口吹石球的小孔，石球会发出“呜、呜”类似螺声的警报声，那浑厚嘹亮的声音会传遍整个紫禁城。警报器指发放警报信号的器具。防空警报指战争期间为了预防敌方空袭而设置的报警系统
10号: 足球场上的10号是个非常重要的数字，是全队的灵魂人物和核心，我们甚至可以这样说，一个球队如果没有一个合格的10号，它就不是一个合格的球队
超声波传感器: 超声波碰到杂质或分界面会产生显著反射形成反射成回波，碰到活动物体能产生多普勒效应。超声波碰到杂质或分界面会产生显著反射形成反射成回波，碰到活动物体能产生多普勒效应。超声波对液体、固体的穿透本领很大，尤其是在阳光不透明的固体中，它可穿透几十米的深度。超声波传感器是利用超声波的特性研制而成的传感器
无源蜂鸣器: 无源蜂鸣器利用电磁感应现象，为音圈接入交变电流后形成的电磁铁与永磁铁相吸或相斥而推动振膜发声，接入直流电只能持续推动振膜而无法产生声音，只能在接通或断开时产生声音
推荐: 释义：推荐：介绍，建议最好去选择你看中的答案，推举。出自《汉书·王莽传上》：“收赡名士，交结将相卿大夫甚众。指把好的人或事物向人或组织介绍，希望被任用或接受
闹钟: 闹钟有很多种类，机械的、石英的，自从它被人利用钟摆的原理发明以来已经成为人们生活中不能缺少的物品。闹钟的机芯结构主要有机械式和石英电子式两大类，其他如晶体管摆轮游丝式、音叉式等类型已很少用。周立波《铁水奔流》三：“镜架跟前放着一口永远不闹，短针老指着五点钟，就是工厂下班时刻的小闹钟
队友: 队友：通常指一个共同团队中的合作者，为达成共同目的而组成的团体中除自己之外的人2：现也指对某人特别失望，或对某人不满及其所做的事，亦可对其的表现称作队友。如：你做这事做的太队友了
示例: 例，是例子、案例的意思，示例：列举、展示出典型的案例、例子已做参照
安全柜: 工作现场可能会使用到不同类型的化学品、药剂、文件、光盘等，因此需要不同类型的安全柜进行储存。可以分为化学品安全柜、文件安全柜、个体防护用品安全柜、气瓶安全柜、通风安全柜等等
在线影院: 在线影院，顾名思义，就是在网络上的电影院，一般特别指的是能够在线直接观看的网上影院
MySQL数据库: MySQL是一种开放源代码的关系型数据库管理系统（RDBMS），MySQL数据库系统使用最常用的数据库管理语言--结构化查询语言（SQL）进行数据库管理。其中”"中是要导出的sql语句,-c指定使用\t进行字段分隔,使用\n进行记录分隔,-S指定数据库服务器及实例,-U指定用户名,-P指定密码.。在不同操作系统或MySQL版本情况下，直接拷贝文件的方法可能会有不兼容的情况发生
扫地机器人: 扫地机器人，又称自动打扫机、智能吸尘、机器人吸尘器等，是智能家用电器的一种，能凭借一定的人工智能，自动在房间内完成地板清理工作。随着国内生活水平的不断提高，原本一直在欧美市场销售的扫地机器人也逐步的走入平常百姓家，并且逐步的被越来越多的人所接受，扫地机器人将在不久的将来像白色家电一样成为每个家庭必不可少的清洁帮手。一般来说，将完成清扫、吸尘、擦地工作的机器人，也统一归为扫地机器人
软件: 软件（中国大陆及香港用语，台湾称作软体，英文：Software）是一系列按照特定顺序组织的计算机数据和指令的集合。软件并不只是包括可以在计算机（这里的计算机是指广义的计算机）上运行的电脑程序，与这些电脑程序相关的文档一般也被认为是软件的一部分。另也泛指社会结构中的管理系统、思想意识形态、思想政治觉悟、法律法规等等。软件被应用于世界的各个领域，对人们的生活和工作都产生了深远的影响。[1]一般来说，计算机软件被划分为编程语言、系统软件、应用软件和介于这两者之间的中间件
局域网: 局域网（Local Area Network，LAN）是在一个局部的地理范围内（如一个学校、工厂和机关内），一般是方圆几千米以内，将各种计算机，外部设备和数据库等互相联接起来组成的计算机通信网。局域网可以实现文件管理、应用软件共享、打印机共享、扫描仪共享、工作组内的日程安排、电子邮件和传真通信服务等功能。局域网可以实现文件管理、应用软件共享、打印机共享、工作组内的日程安排、电子邮件和传真通信服务等功能。依据拓扑结构的不同，局域网又分为以太网、令牌环网、无线局域网等类型
拐杖: 拐杖是一种重要的医疗康复辅助用具,分手杖\肘杖\腋杖,其中手杖主要用于轻度需要,例如老年人或登山者,手杖不属于残疾人用品,肘杖属于中度下肢残疾人用品,。顶端有一个把手，充当行走时的“第三条腿”，稳定身体.现在也有三足或四足的，加强防滑作用，有的还结合了一个折叠小凳子.。”《礼记》载：“孔日蚤作，负手曳杖，逍遥于门
猴子: 是三种类人猿灵长目动物的成员，灵长目是动物界的种群，猴子一般大脑发达，眼眶朝向前方，眶间距窄，手和脚的趾（指）分开，大拇指灵活，多数能与其他趾（指）对握。因此科学上来说，猴并没有形成一个“自然群组”，旧世界猴实际上也接近猿多过新世界猴。新世界猴被分类在小目——阔鼻小目（Platyrrhini）下，旧世界猴（猴总科Cercopithecoidea）则是狭鼻小目（Catarrhini）的一部分，这个目也包括猿。猴并没有形成一个“自然群组”，现存并所知的有264种猴。猴没有任何显著的特征，因为它们的特征都是源于类人猿和猿
自动播放: 当用户点开网页后，视频即开始播放，无需点击播放按钮
五线谱: 在5根等距离的平行横线上，标以不同时值的音符及其他记号来记载音乐的一种方法。等字母表示的，到了罗马时代，开始用另一种符号来表示音的高低，这种记谱法称为“纽姆记谱法”（Neuma）。最早的发源地是希腊，它的历史要比数字形的简谱早得多。在古希腊，音乐的主要表现形式是声乐，歌词发音的高低长短是用A、B、C。五线谱 (Musical Notation) 目前世界上通用的记谱法
输出信号: 信号是反映消息的物理量，是消息的表现形式，信息需要借助某些物理量（如声、光、电）的变化来表示和传递
额外: 额外，指超出定额或范围或脱离红尘
蓝牙串口: 蓝牙串行端口基于SPP协议（Serial Port Profile），能在蓝牙设备之间创建串口进行数据传输。蓝牙串口能在蓝牙设备之间创建串口数据传输。是针对如何在两个不同设备（通信的两端）上的应用之间保证一条完整的通信路径，并在它们之间保持一通信段。如果同时调试多个设备，不但USB口会不够使用，而且由于电缆众多，导致桌面非常凌乱。采用USB转串口的方式，一个设备就要占用一个USB口
遥控车: 根据车体的外型又可分为：房车（平跑车）、越野车、大脚车、拉力车、货柜车等。遥控车即可以通过无线电遥控器远距离控制的模型汽车。一般可分为：玩具、车模(R/C)、警用等几类。遥控车，遥控模型的一种
哔哔哔: 另外，「谁的老母，性感很多人CALL」亦令高登人联想起分享AV而不提供seed的不孝子，而「有差佬将你带走怎算好」亦令高登人联想起玩命，挑战警方的用户。《哔哔哔》的相关影片早已在YouTube上流传，直至2010年9月香港网民转载才引起热潮
FEA: 由邓超明创建，从2007年开始，这套FEA整合营销传播体系已经在陶瓷、涂料、小家电、软件等多个行业里获得了50多起成功的应用，整个体系逐渐成熟，具备了更高的营销杀伤力。一般用 有限元分析软件来计算实际工程问题，如ABAQUS等。FEA是Finite Element Analysis的简写，即 有限元分析，广泛应用于工程分析计算
字样: 字样，拼音zì yàng，意思是文字形体的规范
体验俄罗斯: 《体验俄罗斯》是文汇出版社出版的图书，作者是邵宁
周边: 另外我们常见的借用某个动漫形象生产的具有一定实用性的如文具、服饰、钥扣、手机链等商品被称为软周边，相对价格便宜。慨况一，周边通常指旁边的某物。像扭蛋、挂卡、模型、手办这样没有多少实用价值纯观赏收藏的被称为硬周边。而在国外，这类商品被统称为HOBBY(业余爱好，嗜好)，有硬周边(CORE HOBBY)与软周边(LIGHT HOBBY)的区分。慨况二，国内习惯用周边产品来定义动漫相关产品
土壤: 土壤是地球陆地的表面由矿物质、有机质、水、空气和生物组成的。土壤是固态地球表面具有生命活动，处于生物与环境间进行物质循环和能量交换的疏松表层。土壤（英文名称：Soil）位于地球陆地表面，具有一定肥力，能够生长植物的疏松层。它是矿物和有机物的混合组成部分，存在着固体，气体和液体状态。这些孔隙中含有溶解溶液（液体）和空气（气体）
学号: 学号是为方便对学生的管理，学校为每一位同学分配的一个编号。在自己学校内（大学），一般每个人的学号不会重复
被水: ”《清史稿·世宗纪》：“八月丙午，以 山东 被水较重，特免通省漕粮
船体: 船体，龙骨、旁龙骨、龙筋、肋骨、船首柱、船尾柱等构件组成。实际船舶的船体结构是十分复杂的，而舰船模型的船体结构简单
音乐盒: 八音盒（Music Box，Musical box），是机械发音乐器，1796年由瑞士钟表匠安托·法布尔发明，转动盒内的链环，可自动演奏音乐。音乐盒的起源，可追溯至中世纪欧洲文艺复兴时期。当时为使教会的的钟塔报时，而将大小的钟表上机械装置，被称为“可发出声音的组钟”
妹子: 如今网络媒介上使用的“妹子”一词，其含义大概涵括以下数方面：本义是指妹妹及虽非亲属关系但年龄比自己略小的女性。然而，使它得以进入流行语的含义大概是指“女友”或“关系亲密的女性”这一含义，或广义指年轻女性，在校园文化和ACG（Animation,Comic, Games）次文化中被广泛应用。网络上流行的“妹子”一词在社交网络中流行的同时，更进入日常生活中，在年轻人当中得到广泛使用
USB接口: 通用串行总线（英语：Universal Serial Bus，缩写：USB）是连接计算机系统与外部设备的一种串口总线标准，也是一种输入输出接口的技术规范，被广泛地应用于个人电脑和移动设备等信息通讯产品，并扩展至摄影器材、数字电视（机顶盒）、游戏机等其它相关领域。最新一代是USB 3.1，传输速度为10Gbit/s，三段式电压5V/12V/20V，最大供电100W ，新型Type C插型不再分正反
指正: 指正，拼音是zhǐ zhèng，一是指出错误或缺点，以便改正
第一天: 是华语歌手孙燕姿收录在专辑《完美的一天》 里的一首歌，由陈建宁、阿信、孙燕姿共同做曲。第一天（First Day）取名源自联合创作人的名字，FIR代表飞儿乐团，ST取自孙燕姿英文名Stefanie ，DAY自然取自五月天May Day。李偲菘、李伟菘的“眼泪成诗”
电磁铁: 在铁芯的外部缠绕与其功率相匹配的导电绕组，这种通有电流的线圈像磁铁一样具有磁性，它也叫做电磁铁（electromagnet）。在铁芯的外部缠绕与其功率相匹配的导电绕组，这种通有电流的线圈像磁铁一样具有磁性，它也叫做电磁铁(electromagnet)。这样的电磁铁在通电时有磁性，断电后磁就随之消失。电磁铁是通电产生电磁的一种装置
哆啦: 最高等级100级，一个角色可以拥有大量的亚比。亚比是社区网页游戏《奥拉星》中的产品，类似于宠物、精灵等，可以参与作战
护眼: 护眼就是要预防或消除这种情况，日常应注意对眼睛的呵护，护眼关键是要持之以恒。上班族眼干涩不舒，甚至畏光。这种症状时有发生。不要长期对某一事物用眼，也可以向远处张望一会儿，多看看植物，做做眼保健操。长时间“聚精会神、目不转睛”对眼睛的危害是极大的
夜空中最亮的星: 《夜空中最亮的星》是逃跑计划演唱的一首歌，由逃跑计划填词谱曲，收录于逃跑计划2011年发行的首张专辑《世界》中，同时还是微电影《摘星的你》主题曲[1]。值得一提的是，这首歌还获得了第四届中国摇滚迷笛奖最佳年度摇滚歌曲奖。这首《夜空中最亮的星》投射出来的恬静意境与浪漫情怀，让人动容
电机驱动: 除供利用软线的遥控摄影外，亦可借连接到定时器上的间隔控拍器自动地拍摄，或靠控制快门等，应用面较广。倘不需连拍时，使用自动卷片器亦可。视照相机的种类，将背部盖子换为长胶卷用片盒，即可拍250片格。倘不需连拍时，使用自动卷片器亦可。拍一片格和连拍可以交替，连拍时一般一秒钟拍3—5片格
腾讯: 腾讯权益持有人应占盈利288.06亿元，同比增长21%。2015年6月17日，深圳市政府与腾讯公司签署战略合作协议。腾讯控股有限公司（腾讯）是一家民营IT企业，成立于1998年11月，由马化腾、张志东、许晨晔、陈一丹、曾李青创办，总部在中国广东深圳，是中国最大的互联网综合服务提供商之一。根据《中国移动互联网用户分析2016》的数据显示，腾讯的用户覆盖率高达94.6%，完胜百度和阿里巴巴。腾讯把“连接一切”作为战略目标，提供社交平台与数字内容两项核心服务
直流减速电机: 减速电机是指减速机和电机（马达）的集成体。这种集成体通常也可称为齿轮马达或齿轮电机。使用减速电机的优点是简化设计、节省空间
核心板: 因为核心板集成了核心的通用功能，所以它具有一块核心板可以定制各种不同的底板的通用性，这大大提高了单片机的开发效率。人们也常常将这样一套系统称之为单片机，或者说是嵌入式开发平台。核心板是将MINIPC的核心功能打包封装的一块电子主板
技术总监: 技术总监一般负责一个企业的技术管理体系的建设和维护，制定技术业具有深入理解，对行业技术发展趋势和管理现状具有准确的判断。一个好的技术总监不仅要自身具有很强的技术管理能力，同时，也要有很强的技术体系建设和团队管理的能力，要对企业所在行业具有深入理解，对行业技术发展趋势和管理现状具有准确的判断
电键: 在物理学上，电键通常被叫做“开关”，实际上，与开关不同的是，电键按下松开后会弹起，而平常意义上的开关按下是不能弹起的。种类很多，特指发电报用的按键
DHT: DHT(Distributed Hash Table，分布式哈希表)类似Tracker的根据种子特征码返回种子信息的网络。在不需要服务器的情况下，每个客户端负责一个小范围的路由，并负责存储一小部分数据，从而实现整个DHT网络的寻址和存储。新版BitComet允许同行连接DHT网络和Tracker，也就是说在完全不连上Tracker服务器的情况下，也可以很好的下载，因为它可以在DHT网络中寻找下载同一文件的其他用户
螺旋管: 螺旋管也称螺旋钢管或螺旋焊管，是将低碳素结构钢或低合金结构钢钢带按一定的螺旋线的角度（叫成型角）卷成管坯，然后将管缝焊接起来制成的，它可以用较窄的带钢生产大直径的钢管
响应: B对A使用一张锦囊〔过河拆桥〕，开始进行锦囊效果的结算，此时A对B的锦囊使用〔无懈可击〕来响应（抵消〔过河拆桥〕对A产生的效果），同时，B又有机会对A使用的〔无懈可击〕来进行响应，B可以再用一张〔无懈可击〕来抵消第一个无懈可击产生的效果。in response to] 指其如回响的应答声响应你的要求
图书馆: 图书馆，是搜集、整理、收藏图书资料以供人阅览、参考的机构，早在公元前3000年就出现了图书馆，图书馆有保存人类文化遗产、开发信息资源、参与社会教育等职能。中国古代的各种藏书处所，被后人通称为藏书楼，19世纪末才出现图书馆一词。图书馆是人类社会发展到一定阶段的文明产物，它为一定社会的政治、经济、文化服务，并受它们所制约。据《在辞典中出现的“图书馆”》说，“图书馆”一词最初在日本的文献中出现是1877年的事。根据考古学家的发掘成果，我们已知世界上最早的图书馆也在美索不达米亚
随机数: 随机数是专门的随机试验的结果。产生随机数有多种不同的方法。随机数最重要的特性是它在产生时后面的那个数与前面的那个数毫无关系。这些方法被称为随机数生成器。随机数是专门的随机试验的结果
HTTP请求: 包括：消息首行中，对资源的请求方法、资源的标识符及使用的协议
上传: 将制作好的网页、文字、图片、视频等通过Web或者Ftp传送至互联网上的服务器系统，这一过程称为上传。上传就是将信息从个人计算机（本地计算机）传递到中央计算机（远程计算机）系统上，让网络上的人都能看到。这一过程称为上传。这一过程称为上传
红卫: 红卫是一个乡，它位于四川省绵阳市魏城镇，距离魏城比较近
投稿: 投稿，是作者将自己享有著作权的某一未发表作品投寄给报刊杂志社、广播电视台或出版社并希望被采用的行为
这个人: 歌曲描述的“这个人”曾经互相保护，彼此爱惜，全然信任，最后仍分开，整首歌都充满无限无尽的悲伤，歌曲中的情感见解独到，词曲耐人寻味，曾轶可用稚气未脱的歌声超龄演出，完美超龄表达歌中坚强的勇敢
玩具: 玩具也可以是自然物体，即是沙、石、泥、树枝等等的非人工东西，对玩具应作广义理解，它不是只限于街上卖的供人玩的东西，凡是可以玩的、看的、听的和触摸的东西，都可以叫玩具。玩具泛指可用来玩的物品，通常与儿童或宠物有关。大千世界里形形式式的事物，都可以在玩具世界找到。它是打开智慧天窗的工具，让人们机智聪明。玩玩具在人类社会中常常被作为一种寓教于乐的方式
D6: D6是广州灵创计算机软件有限公司的产品，一款服装ERP系统，对有关于服装的企业进行管理
门铃: “门铃”这玩意在中国古代较少听说，有钱的大户人家是在大门上装有装饰性的门环，叫门的人可用门环拍击环下的门钉发出较大的响声，有现代“门铃”的作用。“门铃”在外国电影的古代片中常有出现，也多是有钱的人户在门前吊着一只硕大的青铜手柄。现在市场上所说的门铃是指不用电池的无线门铃，这是未来门铃的趋势。在近代“门铃”不再是有钱人家的专项，“门铃”已在平民百姓人家广泛普遍应用。马车夫将客人送到门前的时候，会顺便拉拉它牵动里面的铃当以示来人
期许: 期许，指期望，期待，称许，期盼，也指对某人有期盼、有期待的意思
经济发展: 一个国家或者地区按人口平均的实际福利增长过程，它不仅是财富和经济机体的量的增加和扩张，而且还意味着其质的方面的变化，即经济结构、社会结构的创新，社会生活质量和投入产出效益的提高。因而，管理、服务与流通等环节越是精简、廉洁和有效率，就越能促进经济发展。简要说：一个国家摆脱贫困落后状态，走向经济和社会生活现代化的过程即称为经济发展
输出设备: 输出设备（Output Device）是计算机硬件系统的终端设备，用于接收计算机数据的输出显示、打印、声音、控制外围设备操作等。将计算机输出信息的表现形式转换成外界能接受的表现形式的设备。输出设备（OutputDevice）是人与计算机交互的一种部件，用于数据的输出
夜幕降临: 指太阳下山以后，天色渐渐变黑，意味着夜晚的来临。在五人局中，每人拥有10张私人牌库，剩下8张可用牌库，其余的6张弃掉，而18-24张的卡牌意味着游戏局面会不断的重复。指太阳下山以后，天色渐渐变黑，意味着夜晚的来临
演进: 演进是一个汉语词汇，意为演变发展，可见于鲁迅《中国小说史略》第二篇、朱自清《中国歌谣》
序号: 序号，有顺序的号码，如1，2，3，4......大写汉字也算数字序号，如一，二，三，四。而这组数字便称为序列号码
高帆: 高帆，注册管理咨询师，资深企业培训师，营销团队胜任力系统教育专家，职业指南频道、智联招聘、时代光华教育、国家人事人才培训网、香港光华管理学院等著名培训机构特邀讲师，被评为中国咨询业联盟十佳金口才，中国营销教练20强，中国管理科学学会优秀培训师。1938年先后入陕北公学、延安抗大学习。参加了上党、定陶、临汾、晋中等战役。高云鹏，出生于1937年10月8日，笔名：高帆，作家、教授。1988年《青年学诗》(专著)、《世界著名童话家》(专著)，2000年《风月留痕》（诗集）
钢琴: 演奏者通过按下键盘上的琴键，牵动钢琴里面包着绒毡的小木槌，继而敲击钢丝弦发出声音。钢琴（意大利文：pianoforte）是西洋古典音乐中的一种键盘乐器，由88个琴键（52个白键，36个黑键）和金属弦音板组成。钢琴普遍用于独奏、重奏、伴奏等演出，作曲和排练音乐十分方便
电木板: 也称作胶木板、酚醛层压纸板。机械强度良好，主要应用于ICT,ITE治具中绝缘部件的加工,测试治具，硅橡胶按键模具，治具板、模具夹板、台面研磨垫板、包装机、茶盘 梳子等。使用品质优良的漂白木积纸及棉绒纸做为补强物，并以高纯度、全合成的石化原料所反应制成的酚醛树脂做为树脂粘合剂制造而成
红外传感器: 红外传感系统是用红外线为介质的测量系统，按照功能可分成五类， 按探测机理可分成为光子探测器和热探测器。红外传感系统是用红外线为介质的测量系统，按照功能可分成五类， 按探测机理可分成为光子探测器和热探测器。对来自待测目标的辐射调制成交变的辐射光，提供目标方位信息，并可滤除大面积的干扰信号
视觉暂留: 视觉暂留现象即视觉暂停现象（Persistence of vision，Visual staying phenomenon，duration of vision）又称“余晖效应”，1824年由英国伦敦大学教授皮特‘马克’罗葛特在他的研究报告《移动物体的视觉暂留现象》中最先提出。人眼在观察景物时，光信号传入大脑神经，需经过一段短暂的时间，光的作用结束后，视觉形象并不立即消失，这种残留的视觉称“后像”，视觉的这一现象则被称为“视觉暂留”
二维码: 在代码编制上巧妙地利用构成计算机内部逻辑基础的“0”、“1”比特流的概念，使用若干个与二进制相对应的几何形体来表示文字数值信息，通过图象输入设备或光电扫描设备自动识读以实现信息自动处理：它具有条码技术的一些共性：每种码制有其特定的字符集。同时还具有对不同行的信息自动识别功能、及处理图形旋转变化点。每个字符占有一定的宽度。每个字符占有一定的宽度。[1]     2016年8月3日，支付清算协会向   支付机构下发《条码支付业务规范》（征求意见稿），意见稿中明确指出支付机构开展条码业务需要遵循的安全标准
赵洪洋: 学术任职：湖北省神经科学会常务理事，湖北省和武汉市神经外科学会委员。协和医院伽玛刀治疗研究中心主任，外科副主任，神经外科副主任
font: 在微机系统里通常用“fonts”文件夹存放已安装的字体，自己安装字体时，也需要装入“fonts”文件夹中。第一种声明方式参数必须按照如上的排列顺序。忽略的将使用其参数对应的独立属性的默认值。设置或检索对象中的文本特性。每个参数仅允许有一个值
阳台: 阳台不仅可以使居住者接受光照、吸收新鲜空气、进行户外锻炼、观赏、纳凉、晾晒衣物，如果布置得好，还可以变成宜人的小花园，使人足不出户也能欣赏到大自然中最可爱的色彩，呼吸到清新且带着花香的空气。阳台不仅是居住者接受光照、吸收新鲜空气、进行户外锻炼、观赏、纳凉、晾晒衣物的场所。阳台是建筑物室内的延伸，是居住者呼吸新鲜空气、晾晒衣物、摆放盆栽的场所，其设计需要兼顾实用与美观的原则。尽管露台和阳台泛指同一种建筑物，但其实两者有其些微分别，无顶也无遮盖物之平台称露台，有遮盖物者之平台称阳台。阳台一般有悬挑式、嵌入式、转角式三类
家居: 指的是家庭装修、家具配置、电器摆放等一系列和居室有关的甚至包括地理位置（家居风水）都属于家居范畴。家居 指的是家庭装修、家具配置、电器摆放等一系列和居室有关的甚至包括地理位置（家居风水）都属于家居范畴。家居装修风格是以不同的文化背景及不同的地域特色作依据，通过各种设计元素来营造一种特有的装修风格，随着人们对美的不断，室内装修风格也随着增多
A梦: 《A梦》是17k小说网连载的小说，作者是朱可可
光照传感器: 一个被光线照射的表面上的照度（illumination/illuminance）定义为照射在单位面积上的光通量
12月15日: 12月15日是公历一年中的第349天（闰年第350天），离全年结束还有16天。1949年这一天中国人民外交学会成立。1978年这一天《天安门诗抄》出版
十二平均律: 十二平均律是指将八度的音程（一倍频程）按频率等比例地分成十二等份，每一等份称为一个半音即小二度。世界上通用的把一组音（八度）分成十二个半音音程的律制，各相邻两律之间的振动数之比完全相等，亦称“十二等程律”。实践与理论之先后出现，其间相去1685年
3月20日: 3月20日是公历一年中的第79天（闰年第80天），离全年的结束还有286天。2012年联合国将3月20日定为“国际幸福日”。3月20日是每一公历年中的一个时间节点
小说: 小说：以刻画人物形象为中心，通过完整的故事情节和环境描写来反映社会生活的文学体裁。人物、情节、环境是小说三要素。按照篇幅及容量可分为长篇、中篇、短篇和微型小说（小小说）。小说有时候很感人，也很有可读性，好的小说让人百看不厌，深动人心。小说是文学体裁四分法中的一大样式
开源项目: 开源（Open Source，开放源码)被非盈利软件组织(美国的Open Source Initiative协会)注册为认证标记，并对其进行了正式的定义，用于描述那些源码可以被公众使用的软件，并且此软件的使用、修改和发行也不受许可证的限制
详细: 详细是一个汉语词语，有十分清楚，让人明白的意思。详细（拼音：xiáng xì，英译：particular、detail、with circumstance、in detail），形容词，细节、详情。反义词是简略。居下者所分少，故治其详细”。其近义词有详尽、细致、具体
临界值: 临界值是指物体从一种物理状态转变到另外一种物理状态时，某一物理量所要满足的条件，相当于数学中常说的驻点．因此利用临界状态求解物理量的最大值与最小值，就成了物理中求解最值的一种重要的方法。临界值是指物体从一种物理状态转变到另外一种物理状态时，某一物理量所要满足的条件，相当于数学中常说的驻点。有人认为利用临界状态求解最值应谨慎，首先须分清两状态之间的关系
语音识别: 人们预计，未来10年内，语音识别技术将进入工业、家电、通信、汽车电子、医疗、家庭服务、消费电子产品等各个领域。很多专家都认为语音识别技术是2000年至2010年间信息技术领域十大重要的科技发展技术之一。人们预计，语音识别技术将进入工业、家电、通信、汽车电子、医疗、家庭服务、消费电子产品等各个领域。很多专家都认为语音识别技术是2000年至2010年间信息技术领域十大重要的科技发展技术之一。语音识别技术与其他自然语言处理技术如机器翻译及语音合成技术相结合，可以构建出更加复杂的应用，例如语音到语音的翻译
点击: 用 Tablet 笔触摸某项后迅速抬起笔
74HC595: 移位寄存器有一个串行移位输入（Ds），和一个串行输出（Q7’）,和一个异步的低电平复位，存储寄存器有一个并行8位的，具备三态的总线输出，当使能OE时（为低电平），存储寄存器的数据输出到总线。8位串行输入/输出或者并行输出移位寄存器，具有高阻关断状态。74HC595具有8位移位寄存器和一个存储器，三态输出功能。如果两个时钟连在一起，则移位寄存器总是比存储寄存器早一个脉冲
声控灯: 它提供了一种操作简便、灵活、抗干扰能力强，控制灵敏的声控灯，它采用人嘴发出约1秒的控制信号“嘶”声，即可方便及时地打开和关闭声控照明装置，并有防误触发而具有的自动延时关闭功能，并设有手动开关，使其应用更加方便。声控灯是一种声控电子照明装置，由音频放大器、选频电路、延时开启电路和可控硅电路组成。声控灯由话筒、音频放大器、选频电路、倍压整流电路、鉴幅电路、恒压源电路、延时开启电路、可控延时开关电路、可控硅电路组成
LED频闪: LED频闪，即LED液晶显示器屏幕闪烁，LED液晶显示器，在低亮度模式下有背光频闪，类似老式CRT显示器，用手指在屏幕前快速晃动，可见拖影。二是频闪效应：即电光源频闪在人视觉上产生的负效应。频闪深度越大，负效应越大，危害越严重
目录: 天然理心流中的一个段位名称。目录，是着录一批相关文献，按照一定次序编排而成的揭示与报道文献信息的工具。它产生于文献的大量积累和人们对文献利用的需求
游戏截图: 游戏截图，是指把电脑屏幕上看到的游戏画面，拍下来即裁剪下来，保存为图片，可以选择性的拍一部分，效果与你看到的几乎一样 可以自己保存，或者与他人分享
输入设备: 输入设备（InputDevice）是人或外部与计算机进行交互的一种装置，用于把原始数据和处理这些数的程序输入到计算机中。输入设备（InputDevice）是人或外部与计算机进行交互的一种装置，用于把原始数据和处理这些数的程序输入到计算机中。计算机能够接收各种各样的数据，既可以是数值型的数据，也可以是各种非数值型的数据，如图形、图像、声音等都可以通过不同类型的输入设备输入到计算机中，进行存储、处理和输出。键盘，   鼠标，   摄像头，   扫描仪，   光笔，手写输入板，游戏杆，   语音输入装置等都属于输入设备。输入设备：向计算机输入数据和信息的设备
原件: 包括有档案原件，户口原件、保密文件、商标原件、限制文件、法律原件和其他文件原件等。主要指文件中，具有原始法律效益，特别指盖章的文件。最初产生的区别于复制件的原始文件
停车位: 为缓解车位供给严重不足问题，2015年下半年，国家发改委等七部门联合发布《关于加强城市停车设施建设的指导意见》，要求充分调动社会资本积极性，加快推进停车设施建设。停车位微观的就是个人来说，暂时在基础设计没有完善之前，可以租个车位，用遥控车位锁来防止别人占用车位，效果很佳。停车位的问题并不是一天两天能够解决的，这要看我们是否完善设施以及管理和素质
产业: 在传统社会主义经济学理论中，产业主要指经济社会的物质生产部门，一般而言，每个部门都专门生产和制造某种独立的产品，某种意义上每个部门也就成为一个相对独立的产业部门，如“农业”、“工业”、“交通运输业”等。产业主要指经济社会的物质生产部门，一般而言，每个部门都机制专门生产和制造某种独立的产品，某种意义上每个部门也就成为一个相对独立的产业部门，如“农业”、“工业”、“交通运输业”等。生产物质产品的集合体，包括农业、工业、交通运输业等部门，一般不包括商业。经济学上，惯常把产业分门别类。由此可见，“产业”作为经济学概念，其内含与外延的复杂性
引脚: 引脚可划分为脚跟（bottom）、脚趾（toe）、脚侧（side）等部分。C1是来消除场脉冲的电容器，R1是把控制电流转变为电压的电阻，而C2是用来平滑的滤波器，该脚的输出被限制在±2Vf之内。引线末端的一段，通过软钎焊使这一段与印制板上的焊盘共同形成焊点。引脚，又叫管脚，英文叫Pin
qq: 2017年1月5日，腾讯QQ和美的集团在深圳正式签署战略合作协议，双方将共同构建基于IP授权与物联云技术的深度合作，实现家电产品的连接、对话和远程控制。腾讯QQ支持在线聊天、视频通话、点对点断点续传文件、共享文件、网络硬盘、自定义面板、QQ邮箱等多种功能，并可与多种通讯终端相连。其标志是一只戴着红色围巾的小企鹅
字幕: 字幕（subtitles of motion picture）是指以文字形式显示电视、电影、舞台作品中的对话等非影像内容，也泛指影视作品后期加工的文字。字幕指以文字形式显示电视、电影、舞台作品里面的对话等非影像内容，也泛指影视作品后期加工的文字。影视作品的对话字幕，一般出现在屏幕下方，而戏剧作品的字幕，则可能显示于舞台两旁或上方
盲人: 视障人士主要分为两类，一为失明或称全失明（即盲人），二为弱视（低于正常视力60%）。相对于视障人士来说，视觉无碍的人则叫做明眼人、开眼人、健视人。”盲人是指视觉有障碍的人。” 清李渔 《闲情偶寄·词曲下·格局》：“是西施 之美，不特有目者赞之，盲人亦能赞之矣。亦喻胡涂、不明事理的人
编码: 编码是信息从一种形式或格式转换为另一种形式的过程也称为计算机编程语言的代码简称编码。编码是信息从一种形式或格式转换为另一种形式的过程。解码，是编码的逆过程。编码在电子计算机、电视、遥控和通讯等方面广泛使用。数字系统中常用的编码有两类，一类是二进制编码，另一类是十进制编码
PM2.5值: 由此，我们就知道了PM2.5，就是指：直径小于或等于2.5μm的尘埃或飘尘在环境空气中的浓度。其定义是监测环境空气中尘埃或飘尘的空气当量直径为10μm的尘埃或飘尘在环境空气中的浓度。大气污染物因子有很多种，当前我国环境保护部门监测环境大气污染物时采用的是PM10这个指标
定值电阻: 制作定值电阻时，为了能在温度变化情况下保证电阻近似不变一般都是选用电阻率与温度几乎无关的材料做导体（绕制定值电阻）.也就是说材料的电阻几乎与温度变化无关)，一般都是选用些合金材料
数据线: 数据线（data cable），其作用是来连接移动设备和电脑的，来达到数据传递或通信目的。数据线（data canle），其作用是来连接移动设备和电脑的，来达到数据通信目的。通俗点说，就是连接电脑用来传送铃图片等类文件的通路工具。数据线按照接口分为COM接口和USB接口
厕所门: 视频场景为一厕所内，两年轻人正进行疑似性行为的举动，女生穿着绿色裙，男生穿着红白T恤，男生站在女生后面，两人有一些亲密举动，女生发出呻吟声，旁边似有人在持手机拍摄。网站出于法律方面考虑实施封帖，但网友对此帖的讨论愈加热烈，余波未平。在厕所发生性行为，这不仅出现在情色小说中，在广东佛山还有现实版本
服务: 服务是指为他人做事，并使他人从中受益的一种有偿或无偿的活动。其特性表现为无形性、异质性、生产消费的同步性、易逝性。其所涉及的形式包括在顾客提供的有形产品上所完成的活动，在顾客提供的无形产品上所完成的活动，无形产品的交付，为顾客创造氛围等
叫醒服务: 叫醒服务是37游戏推出的一款特色APP——世界杯闹钟的功能，该APP不但能查询世界杯赛事，还能提供叫醒服务，提醒比赛开始时间。该软件的闹钟风格多样，轻松搞笑，有容嬷嬷、小新他妈、拼命搓我等各具特色的声音设定。该软件的闹钟风格多样，轻松搞笑，有容嬷嬷、小新他妈、拼命搓我等各具特色的声音设定
验证码: 验证码（CAPTCHA）是“Completely Automated Public Turing test to tell Computers and Humans Apart”（全自动区分计算机和人类的图灵测试）的缩写，是一种区分用户是计算机还是人的公共全自动程序。验证码（CAPTCHA）是“Completely Automated Public Turing test to tell Computers and Humans Apart”（全自动区分计算机和人类的图灵测试）的缩写，是一种区分用户是计算机和人的公共全自动程序
字体: 字体的艺术性体现在其完美的外在形式与丰富的内涵之中。字体，又称书体，是指文字的风格式样。是技术制图中的一般规定术语，是指图中文字、字母、数字的书写形式。2.微机系统的字体font。这类字体是   电脑必用字体，存在于“   fonts”   文件夹里
地理坐标: 地理坐标是用纬度、经度表示地面点位置的球面坐标。地理坐标系以地轴为极轴，所有通过地球南北极的平面，均称为子午面
恶作剧: 这种恶作剧纯粹是以满足行为人个人乐趣为目的，其他观看者或被恶作剧的人不一定也会觉得有趣，而且往往适得其反地令人憎恶。这种恶作剧有时已经达到了欺凌或犯罪的程度，可能会面临始料未及的严重后果。恶作剧最基本的形式即是故意使他人陷入窘境，并在旁观赏他人尴尬、吃惊、惶恐等等寻常难以得见的情绪表现，借此得到乐趣
绘制: 绘制，读作huì zhì，汉语词语，是指用笔或其他绘图工具描画制作
.io: .io是(British Indian Ocean Territory) 英属印度洋领地的简写
检测器: 对检测器的要求是：灵敏度高，线性范围宽，重现性好，稳定性好，响应速度快，对不同物质的响应有规律性及可预测性。检测器指能检测色谱柱流出组分及其量的变化的器件。检测器通常分为积分型和微分型两类
1时间: 《1时间》是ハンバート ハンバート演唱的歌曲，发行于2006年10月25日
支付宝: 支付宝与国内外180多家银行以及VISA、MasterCard国际组织等机构建立战略合作关系，成为金融机构在电子支付领域最为信任的合作伙伴。支付宝与国内外180多家银行以及VISA、MasterCard国际组织等机构建立战略合作关系，成为金融机构在电子支付领域最为信任的合作伙伴。支付宝（中国）网络技术有限公司是国内领先的第三方支付平台，致力于提供“简单、安全、快速”的支付解决方案。在进入移动支付领域后，为零售百货、电影院线、连锁商超和出租车等多个行业提供服务。包括网购担保交易、网络支付、转账、信用卡还款、手机充值、水电煤缴费、个人理财等多个领域
干电池: 智研数据研究中心表明，目前我国正逐渐缩小与国际领先技术的差距，在部分核心技术方面已达到国际水平，并且越来越多地进入国际市场。智研数据研究中心表明，目前我国正逐渐缩小与国际领先技术的差距，在部分核心技术方面已达到国际水平，并且越来越多地进入国际市场。干电池是一种伏打电池，利用某种吸收剂（如木屑或明胶）使内含物成为不会外溢的糊状。它们可以使用于很多电器用品上，常见的干电池为锌锰电池
四轴飞行器: 四轴飞行器的四个螺旋桨都是电机直连的简单机构，十字形的布局允许飞行器通过改变电机转速获得旋转机身的力，从而调整自身姿态。具体的技术细节在“基本运动原理”中讲述。近年来得益于微机电控制技术的发展，稳定的四轴飞行器得到了广泛的关注，应用前景十分可观。国际上比较知名的四轴飞行器公司有中国大疆创新公司、法国Parrot公司、德国AscTec公司和美国3D Robotics公司。[1] 因为它固有的复杂性，历史上从未有大型的商用四轴飞行器
电子元件: 常用的电子元件有：电阻、电容、电感、电位器、变压器等，就安装方式而言，目前可分为传统安装（又称通孔装即DIP）和表面安装两大类（即又称SMT或SMD）。电子元件是电子电路中具有某种独立功能的单元。这种单元不能从总体上进一步分割，否则就会失去其使用特性
温馨提示: 随碟附送的DVD收录举行的「Neway Music Live x 洪卓立」和4支MV：《蓝色星球》、《蓝色星球》（国）、《温馨提示》及《一夜情》，歌迷对这个音乐会反应极为热烈，不但曾掀起炒飞热潮，内地歌迷更拉大队来港支持。所属专辑：《透视洪卓立》
鼠标: ，该研究所是斯坦福大学赞助的一个机构，Douglas Engelbart很早就在考虑如何使电脑的操作更加简便，用什么手段来取代由键盘输入的繁琐指令。美国科学家道格拉斯·恩格尔巴特（Douglas Englebart）在加利福尼亚制作了第一只鼠标。鼠标是一种很常用的电脑输入设备，分有线和无线两种
近视: 古代医籍对本病早有认识，称为目不能远视，又名能近怯远症，至《目经大成》始称近视。近视眼是屈光概念，指一类近视性屈光不正。包括屈光性近视和轴性近视两种，一般所称的近视眼属于屈光性近视，因此近视与近视眼是两个不同的概念。近视是一个视力概念，指目光所及的范围内看不清远物、却看清近物的症状。屈光近视可达到600度以上，即高度近视
低电平: 低电平（Vil）指的是保证逻辑门的输入为低电平时所允许的最大输入低电平，当输入电平低于Vil时，则认为输入电平为低电平
蓝牙模块: 蓝牙模块，是一种集成蓝牙功能的PCBA板，用于短距离无线通讯，按功能分为蓝牙数据模块和蓝牙语音模块。蓝牙模块的接口分串行接口、USB接口、数字IO口、模拟IO口、SPI编程口及语音接口。蓝牙模块是一种集成蓝牙功能的PCBA板，用于短距离无线通讯，按功能分为蓝牙数据模块和蓝牙语音模块
门禁系统: 出入口门禁安全管理系统是新型现代化安全管理系统，它集微机自动识别技术和现代安全管理措施为一体，它涉及电子，机械，光学，计算机技术，通讯技术，生物技术等诸多新技术。在车场管理应用中，车辆门禁是车辆管理的一种重要手段，不以收取停车费为目的，主要是管理车辆进出权限。它是解决重要部门出入口实现安全防范管理的有效措施。它是解决重要部门出入口实现安全防范管理的有效措施。在车场管理应用中，车辆门禁是车辆管理的一种重要手段，不以收取停车费为目的，主要是管理车辆进出权限
风扇转速: 风扇转速由电机内线圈的匝数、工作电压、风扇扇页的数量、倾角、高度、直径和轴承系统共同决定。风扇转速是指风扇扇页每分钟旋转的次数，单位是rpm
概述: 概述也广泛应用于商业或营销领域里面，是针对一件即将发生的事情的描述，防止客户或顾客产生过多的压力感，从而达到良好沟通的效果。更有可转动闪光灯头，从而精密控制主体阴影
bilibili: bilibili网站最大的特色是悬浮于视频上方的实时评论功能，爱好者称其为“弹幕”，这种独特的视频体验让基于互联网的即时弹幕能够超越时空限制，构建出一种奇妙的共时性的关系，形成一种虚拟的部落式观影氛围，让bilibili网站成为极具互动分享和二次创造的潮流文化娱乐社区。网站最初以借鉴其他视频分享网站的资源为主，在国内逐渐注重版权的大形势下进行了合化。该网站于2010年1月24日更名为bilibili，且拥有有别于AcFun等视频弹幕网站的弹幕系统。bilibili网站目前也是众多网络热门词汇的发源地之一
S8050: S8050是一款小功率NPN型硅管，基极电压为40V，集电极电流为0.5A。S8050是华强北市场畅销的半导体三极管型号之一，2010年1月至9月中旬，华强北电子市场半导体三极管S8050平均交易价格为0.034元/pcs
OLED: 有机发光二极管（Organic Light-Emitting Diode, UIV OLED）又称为有机电激光显示、有机发光半导体（Organic Electroluminesence Display, UIV OLED）。OLED显示技术具有自发光的特性，采用非常薄的有机材料涂层和玻璃基板，当有电流通过时，这些有机材料就会发光，而且OLED显示屏幕可视角度大，并且能够节省电能。OLED，有机发光二极管又称为有机电激光显示（Organic Light-Emitting Diode，OLED），由美籍华裔教授邓青云在实验室中发现，由此展开了对OLED的研究。OLED由美籍华裔教授   邓青云（Ching W. Tang）1979年在实验室中发现，由此展开了对OLED的研究。与液晶显示（Liquid Crystal Display, LCD）是不同类型的发光原理
谱子: 谱子，指曲谱，乐谱，用来记录音乐的资料。” 洪深 《鸡鸣早看天》第一幕：“我一定要找你先略略地谈一谈，回头说话才有谱子。谱子，指曲谱，乐谱，用来记录音乐的资料
防毒: 如在计算机上安装防病毒软件，以便在病毒侵入系统时发出警报，并记录携带病毒的文件，及时清除其中的病毒。防毒是指根据系统特性，采取相应的系统安全措施预防病毒侵入计算机。对网络而言，能够向网络管理员发送关于病毒入侵的信息，记录病毒入侵的工作站，必要时还能够注销工作站，隔离病毒源
程序猿: 一般分为程序设计猿和程序编码猿，但两者的界限并不非常清楚，都可以进行开发、维护工作，特别是在中国，而且最重要的一点，二者都是一种非常悲剧(加班)的存在。程序猿（Programmer Monkey），对从事程序开发工作的人员戏谑昵称。一般程序猿都很固执，聪明、健谈、兴趣广泛，他们在大学和工作前就开始接触程序，对技术充满激情，将编程作为一种爱好
javascript: 它的解释器被称为JavaScript引擎，为浏览器的一部分，广泛用于客户端的脚本语言，最早是在HTML（标准通用标记语言下的一个应用）网页上使用，用来给HTML网页增加动态功能。但实际上它的语法风格与Self及Scheme较为接近。为了取得技术优势，微软推出了JScript，CEnvi推出ScriptEase，与JavaScript同样可在浏览器上运行。当时服务端需要对数据进行验证，由于网络速度相当缓慢，只有28.8kbps，验证步骤浪费的时间太多
柜子: 到了明清时期，柜子成为室内必备的家具，且形制已定型。柜子（拼音：guì zǐ，英文名：cabinet），指收藏衣物、文件等用的器具，方形或长方形，一般为木制或铁制。在擦拭木质衣柜表面时，不要让酒精、清洁剂等有腐蚀性的化学物品直接接触木质表面，这对衣柜有一定的损害。明清柜子按形制可分为方角柜、圆角柜、亮格柜，形制不同，其构成部件也有不同。柜类家具主要是指以木材、人造板或金属等材料制成的各种用途不同的柜子
支付平台: 支付平台实际上就是买卖双方交易过程中的“中间件”，也可以说是“技术插件”。支付平台实际上就是买卖双方交易过程中的“中间件”，也可以说是“技术插件”。是在银行监管下保障交易双方利益的独立机构。是在银行监管下保障交易双方利益的独立机构
最小系统: 最小系统，是最基本的硬件和软件环境。这个最小系统主要用来判断系统是否可完成正常的启动与运行.对于软件故障的检查，硬盘中的软件环境只有一个基本的操作系统环境，可能是卸载掉所有应用、或是重新安装一个干净的操作系统环境、是要判断系统问题，软件冲突或软硬件间的冲突问题
土壤湿度传感器: FDR(Frequency Domain Reflectometry)频域反射仪是一种用于测量土壤水分的仪器，它利用电磁脉冲原理、根据电磁波在介质中传播频率来测量土壤的表观介电常数(ε)，从而得到土壤容积含水量(θv)，FDR具有简便安全、快速准确、定点连续、自动化、宽量程、少标定等优点。是一种值得推荐的土壤水分测定仪器。FDR型的技术参数、应用及特点
一定可以: 一定可以是歌手张信哲信仰专辑中的歌曲，由姚若龙作词，许华强作曲，由张信哲演唱
0A: 这主要是因为随着计算机技术、通信技术和网络技术的突飞猛进，关于OA的描述也在不断充实，但至今还没有人对OA下过最权威、最科学、最全面、最准确的定义。但是有100个人会说出100种不同层次、不同内容的解说。有100家单位会有100种不同层次、不同内容的应用需求。OA是Office Automation的缩写，指办公室自动化或自动化办公。100个厂商会有100种不同技术类型、不同层次、不同定义的系统
机械波: 机械波的传播需要特定的介质，在不同介质中的传播速度也不同，在真空中根本不能传播，而电磁波（例如光波）可以在真空中传播。机械波的传播需要特定的介质，在不同介质中的传播速度也不同，在真空中根本不能传播。机械波与电磁波既有相似之处又有不同之处，机械波由机械振动产生，电磁波由电磁振荡产生。机械波是机械振动所产生，机械振动在介质中的传播称为机械波。机械波的传递一定要有介质，有机械振动但不一定有机械波产生
网络数据传输: 网络数据传输，WCDMA全名是WidebandCDMA，中文译名为“宽带分码多工存取”，它可支持384Kbps到2Mbps不等的数据传输速率，在高速移动的状态，可提供384Kbps的传输速率，在低速或是室内环境下，则可提供高达2Mbps的传输速率。而GSM系统目前只能传送9.6Kbps，固定线路Modem也只是56Kbps的速率，由此可见WCDMA是无线的宽带通讯
二进制: 19世纪爱尔兰逻辑学家乔治布尔对逻辑命题的思考过程转化为对符号"0''.''1''的某种代数演算，二进制是逢2进位的进位制。当前的计算机系统使用的基本上是二进制系统，数据在计算机中主要是以补码的形式存储。20世纪被称作第三次科技革命的重要标志之一的计算机的发明与应用，因为数字计算机只能识别和处理由0和1符号串组成的代码。计算机中的二进制则是一个非常微小的开关，用“开”来表示1，“关”来表示0。0、1是基本   算符
上线: 揭露传销的电视连续剧《上线》（根据一部真实洗脑的故事改编）一个震惊全国的大案，涉案人员上万人、涉及资金数十亿元。一部得到国家公安部高度关注与支持、全力推介的反腐反黑电视剧，在深层剖析了一批社会普通者在现实生活中的无奈挣扎、在“欲望”的大漩涡里无法自拔的人生悲剧。一部最生动、最真实地记录也是甄别传销直销的教科书
百度: 1999年底,身在美国硅谷的李彦宏看到了中国互联网及中文搜索引擎服务的巨大发展潜力，抱着技术改变世界的梦想，他毅然辞掉硅谷的高薪工作，携搜索引擎专利技术，于 2000年1月1日在中关村创建了百度公司。2016年5月16日，百度与安徽省芜湖市人民政府在北京签订合作协议。“百度”二字源于中国宋朝词人辛弃疾的《青玉案·元夕》词句“众里寻他千百度”，象征着百度对中文信息检索技术的执着追求。6月13日，百度与泰国旅游局召开新闻发布会，双方正式签订战略合作备忘录。美国时间2015年9月23日，微软与百度签署合作协议
出水口: 出水口排水管渠出水口的位置、形式和出口流速，出水口有多种形式，常见的有一字式、八字式和门字式
pdf: pdf（Portable Document Format的简称，意为“便携式文档格式”），是由Adobe Systems用于与应用程序、操作系统、硬件无关的方式进行文件交换所发展出的文件格式。PDF文件格式可以将文字、字型、格式、颜色及独立于设备和分辨率的图形图像等封装在一个文件中。Adobe公司设计PDF文件格式的目的是为了支持跨平台上的，多媒体集成的信息出版和发布，尤其是提供对网络信息发布的支持。为了达到此目的， PDF具有许多其他   电子文档格式无法相比的优点。这种   文件格式与   操作系统平台无关，也就是说，PDF文件不管是在   Windows，   Unix还是在苹果公司的   Mac OS操作系统中都是通用的
计时器: 计时器，是利用特定的原理来测量时间的装置。计时器，是指利用特定的原理来测量时间的装置。在计算机专业术语中指使能够指定要在指定时间调用的委托的轻量对象
com: 历史上第一个com域名的诞生是在1985年3月15日，当时个人电脑操作系统主要还是使用MS-DOS3.0操作系统。com为commercial简称，表示商业性质的，com结尾的域名为最早通用的顶级域名
.edu: edu 是互联网的通用顶级域之一，主要供教育机构，如大学等院校使用。它原供全世界的教育机构使用，但实际使用的教育机构大部份位于美国
湿度传感器: 从制造角度看，同是湿度传感器，材料、结构不同，工艺不同．其性能和技术指标（像精度方面）有很大差异，因而价格也相差甚远。对使用者来说，选择湿度传感器时，首先要搞清楚需要什么样的传感器。由于应用领域不同，对湿度传感器的技术要求也不
联系方式: 随着信息技术的不断发展及更新，现今的联系方式表达更是异彩纷呈：QQ号码、MSN地址、飞信号码、电子邮箱、手机号码、百度用户名、微信等。早期主要以普通信件形式体现：电报挂号、邮政编码、详细地址、固定电话号等。联系方式，能够达到对个人直接沟通的相关信息，多用于聊天、交流
蜂鸣器: 蜂鸣器是一种一体化结构的电子讯响器，采用直流电压供电，广泛应用于计算机、打印机、复印机、报警器、电子玩具、汽车电子设备、电话机、定时器等电子产品中作发声器件。蜂鸣器在电路中用字母“H”或“HA”（旧标准用“FM”、“ZZG”、“LB”、“JD”等）表示。蜂鸣器主要分为压电式蜂鸣器和电磁式蜂鸣器两种类型
手环: 手环是人类发展历史上的一种配饰，在不同时期不同场合对于不同的人物具有不同的意义。手环制造材料五花八门，有塑料的、金属的、树枝的、花束的、水晶的等等。在不同时期不同场合对于不同的人物具有不同的意义
51单片机: 该系列单片机的始祖是Intel的8004单片机，后来随着Flash rom技术的发展，8004单片机取得了长足的进展，成为应用最广泛的8位单片机之一，其代表型号是ATMEL公司的AT89系列，它广泛应用于工业测控系统之中。很多公司都有51系列的兼容机型推出，国产宏晶STC单片机以其低功耗、廉价、稳定性能，占据着国内51单片机较大市场。需要注意的是52系列的单片机一般不具备自编程能力。很多公司都有51系列的兼容机型推出，很长的一段时间内将占有大量市场。51单片机是对所有兼容Intel8031指令系统的单片机的统称
的那: 的那是汉语词汇，拼音为de nà，出自《儿女团圆》。婆婆也，你把那鸡儿快宰，好酒频釃。”元秦简夫《东堂老》第一折：“着我那大姐宜时景，带舞带唱华严的那海会。高等生物性别发育有关基因的时空表达
2017年: 农历丁酉年（鸡年），闰六月，共384天。农历闰六月，共384天。2017年处于21世纪第2个10年，是中华人民共和国成立第68周年
技术方案: 内容可包括科研方案、计划方案、规划方案、建设方案、设计方案、施工方案、施工组织设计、投标流程中的技术标文件、大型吊装作业的吊装作业方案、生产方案、管理方案、技术措施、技术路线、技术改革方案，等等。技术方案是为研究解决各类技术问题，有针对性，系统性的提出的方法、应对措施及相关对策。专利文献中，技术方案是指清楚完整地描述发明或实用新型解决其技术问题所采取的技术特征组合
红外接收: 红外接收是指使用红外接收头接收红外线发射管所发出的红外线，波长在750-1150NM
LM35: LM35 是由National Semiconductor 所生产的温度传感器，其输出电压为摄氏温标
气象站: 气象站根据用途、安装及精确度可分为：便携式气象站、高精度气象站、高速公路气象站、森林火险气象站及校园气象站、电力气象站、光伏气象站、景区气象站、社区气象站。主要用于采集温度、湿度、风向、风速、太阳辐射、雨量、气压、光照度、土壤温度、土壤湿度、露点等多项信息并做公告和趋势分析。根据用途、安装及精确度可分为：便携式气象站、高精度气象站、高速公路气象站、森林火险气象站及校园气象站
飞控: 飞控就是航模遇到风时副翼升降舵会自动修正到水平位置，换句话说，装了飞控飞机你用油门巡航时，就算有风他也会保持稳定向前飞不会有偏转，不过目前国内固定翼的飞控技术还一般，只对一些小型固定翼飞机有效果
梳子: 梳子在品种上分实用品梳、工艺梳、旅游梳、高档精品梳、保健梳等五大系列300多个品种。梳理头发的工具。在华夏上古文明时代，由轩辕黄帝的王妃——方雷氏启发于鱼骨而发明创造，最初得名因用木头所制，也称为木梳。梳子的种类繁多，如桃木梳、檀木梳和牛角梳等
蓝牙: 蓝牙技术联盟在全球拥有超过25,000家成员公司，它们分布在电信、计算机、网络、和消费电子等多重领域。有了整合在Mac OS X中的蓝牙无线技术，你就可以轻松连接你的Apple电脑和基于Palm操作系统的便携设备、移动电话以及其它外围设备―在9米（30英尺）距离之内以无线方式彼此连接。简言之，蓝牙技术让各种数码设备之间能够无线沟通，让散落各种连线的桌面成为历史。蓝牙技术拥有一套专利网络，可发放给符合标准的设备。蓝牙技术联盟负责监督蓝牙规范的开发，管理认证项目，并维护商标权益
电池: 利用电池作为能量来源，可以得到具有稳定电压，稳定电流，长时间稳定供电，受外界影响很小的电流，并且电池结构简单，携带方便，充放电操作简便易行，不受外界气候和温度的影响，性能稳定可靠，在现代社会生活中的各个方面发挥有很大作用。电池是指盛有电解质溶液和金属电极以产生电流的杯、槽或其他容器或复合容器的部分空间，能把化学能或者光能转变为电能的装置，主要有化学电池、太阳能电池和原子能电池。电池放电的负极为阳极，放电的正极为阴极，在阳极两类导体界面上发生氧化反应，在阴极的两类导体界面上发生还原反应
爱心: 所谓爱心是指同情怜悯之心态（包括相应的一定行动），它是一种奉献精神，也是关怀、爱护人的思想感情，包括于所有情感之中。当对象为人类时，往往与"阶级友爱"或"同胞情"相对应，指超阶级的或超国的、基于彼此都是人类这一认识的同情怜悯，当对象为非人类时，则往往基于彼此都是动物或生命这一认识的同情怜悯
毕业晚会: 《毕业晚会》是一款装扮小游戏，游戏大小为1727K
待机状态: 目前人们通常所说的待机状态均指手机或电脑等电子设备的开机但是不进行任何实质性工作（及不对文件和程序的各种操作）的状态
摩斯: 摩斯是漫画《黑瞳》中的角色。摩斯是魔兽世界中的国家
排针: 而随着排针连接器市场的竞争，现在有部分厂家从电镀（仿金）及材质（青包钢，合金等）上入手降低成本，但同样也降低了产品的使用特性及寿命。一般与其配对使用的有排母，线端等连接器。排针一般广泛被应用于PCB板的连接上，有万用连接器的美名。根据封装用法则有贴片SMT（卧贴/立贴），插件DIP（直插/弯插）等。通常与排母配套使用，构成板对板连接
新闻报道: 1、自主性：新闻界自主选择报道或者揭露目标，自主进行调查活动。不是依赖当局发表的材料写报道，而是记者亲自进行调查，逼近真相。一般读新闻报道的习惯是：通篇浏览标题，优中选优，不留死角，仔细阅读。具体地讲，新闻是一种客观存在的事实。在内容上是新鲜的
体感游戏: Wii 的内部开发代号是“The Revolution”(大革命)，而它也的确名副其实：用户们第一次发现原来除了传统的手柄按键控制之外，自己还可以直接用身体动作来控制屏幕上的游戏人物。它由日本任天堂游戏公司最先推出，经过发展有嵌入式、健身器械式等类型，在玩家体验、技术支持等方面都有广阔的发展前景。体感游戏突破了以往单纯以手柄按键输入的操作方式，而是通过肢体动作变化来进行操作
QQ群: QQ群是腾讯公司推出的多人聊天交流服务，群主在创建群以后，可以邀请朋友或者有共同兴趣爱好的人到一个群里面聊天。群是为QQ用户中拥有共性的小群体建立的一个即时通讯平台。QQ群的理念是群聚精彩，共享盛世，可以让很多人在一起聊天。可以设置管理员，帮助群主管理QQ群，可以改马甲
面包: 以小麦粉为主要原料，以酵母、鸡蛋、油脂、糖、盐等为辅料，加水调制成面团，经过分割、成形、醒发、焙烤、冷却等过程加工而成的焙烤食品。以小麦粉为主要原料，以酵母、鸡蛋、油脂、果仁等为辅料，加水调制成面团，经过发酵、整型、成型、焙烤、冷却等过程加工而成的焙烤食品。以面包为日常主要碳水化合物食物来源的国家还是集中在欧洲、北美、南美、澳洲、中东以及亚洲、非洲的一些国家
分管: 分管是一个汉语词汇，拼音为fēn guǎn，基本意思是按照分工负责管理
优惠券: 优惠券，给持券人某种特殊权利的优待券（如赊购物品或享受一定折扣）。这个词起源于19世纪20年代法国，从法国动词“Coupon”[意思是“to cut”（中文：削减）]演变而来。优惠券可分为电子优惠券、纸质优惠券、手机优惠券、银行卡优惠券
DHT11: DHT11是一款有已校准数字信号输出的温湿度传感器。精度湿度+-5%RH， 温度+-2℃，量程湿度20-90%RH， 温度0~50℃
程序模块: EXE文件（又称为应用程序模块），或一个动态链接库（DLL — Dynamic Linking Library，又被称为动态链接库模块或DLL模块），或一个设备驱动程序，也可能是一个程序包含的能被另一个程序存取的数据资源。在Windows中，术语“模块”一般是指任何能被装入内存中运行的可执行代码和数据的集合。EXE文件（又称为应用程序模块），或一个动态链接库（DLL—Dynamic Linking Library，又被称为动态链接库模块或DLL模块），或一个设备驱动程序。模块一词也被用于特指自包含的一段程序。更明确地讲，模块指的就是一个
抽奖: 以抽签发给买主奖品。以抽签法给买主奖品。商人招徕顾客的一种手段
高温预警: 高温预警信号分三级，分别以黄色、橙色、红色表示[1]。中央气象台2013年8月11日18时继续发布高温橙色预警，这是自2007年开始有高温预警机制后，中央气象台首次连续18天发布高温最高级别预警信号。浙江、江苏、安徽、湖北、湖南、江西等地的部分地区最高气温可达40～42℃。高温预警等级划分　　预警信号分三级，分别以黄、橙、红表示
快递: 2017年3月28日，国家邮政局发布2016年中国快递发展指数报告显示，我国快递业务量规模继续稳居世界首位，在全球占比超过四成，对世界快递业务量增长的贡献率达60%。全国乡镇快递服务覆盖率已超过70%，部分东部省份已经实现“镇镇有网点”。2015年12月25日从国家邮政局网站获悉，中国快递年业务量首次突破200亿件大关，继续稳居世界第一。快递泄露信息罚3万，需当场拆开包装验视内件。2013年12月22日，国家邮政局宣布在全国范围内开展收寄验视专项检查
红外接收器: 红外线接收器是一种可以接收红外信号并能独立完成从红外线接收到输出与TTL电平信号兼容的器件，体积和普通的塑封三极管差不多，适合于各种红外线遥控和红外线数据传输
荧光棒: 荧光棒，外形多为条状，外层以聚乙烯（塑料）包装，内置一玻璃管夹层，夹层内外液体分别为过氧化物和酯类化合物，经弯折、击打、揉搓等使玻璃破裂，引起两种化合物反应致使荧光染料发光。严禁用刀或剪刀弄破荧光棒的塑料管。发光的原理就是过氧化物和酯类化合物发生反应，将反应后的能量传递给荧光染料，再由染料发出荧光
外卖: 随着电话、手机、网络的普及，外卖行业得到迅速的发展。随着电话、手机、网络的普及，外卖行业得到迅速的发展。外卖是个很广泛的词汇。大家一般的理解就是快餐的外送服务，说的就是中餐像一荤一素的那种，还有就是西式的。其实这些都是属于外卖的
全球: 广义指地球上的人文环境，经济，生态自然， 包括世界上的各个方面。泛指地球上整个人类社会和自然界
电磁阻尼: 当导体在磁场中运动时，感应电流会使导体受到安培力，安培力的方向总是阻碍导体的运动，这种现象称为电磁阻尼。这是由于与指针相连的线圈在磁场中摆动时产生了感应电流，线圈受到安培力形成的阻力矩的作用，使指针摆幅迅速衰减。电磁阻尼现象广泛应用于需要稳定摩擦力以及制动力的场合，例如电度表、电磁制动机械，甚至磁悬浮列车等
数据手套: 数据手套的出现，为虚拟现实系统提供了一种全新的交互手段，目前的产品已经能够检测手指的弯曲，并利用磁定位传感器来精确地定位出手在三维空间中的位置
一点爱: 敏少《一点爱》EP由著名音乐人，弦子、李宇春等当红歌手的金牌御用作曲家朱振声Marko为其量身打造，纳尼娱乐文化荣誉出品、倾力推荐。给这方土叠上爱，一点一寸便花开,繁荣像缤纷的霓虹，世界乐同
体育场: 指有400米跑道（中心含足球场），有固定道牙，跑道6条以上，并有固定看台的室外田径场地。体育场按看台容纳观众人数分为：甲级25000人以上，乙级15000-25000人，丙级5000-15000人，丁级5000人以下。体育场主要由中心场地、看台组成，之间一般配有田径场
硬件基础: 当硬件监控芯片与各种传感元件（电压、温度、转速）配合时，便能在硬件工作状态不正常时，自动采取保护措施或及时调整相应元件的工作参数，以保证电脑中各配件工作在正常状态下。为了让用户能够了解硬件的工作状态（温度、转速、电压等），主板上通常有一块至两块专门用于监控硬件工作状态的硬件监控芯片。常见的有温度控制芯片和通用硬件监控芯片等等
原图: 原图是直接由实测而成的并据以派生其他地图的大比例尺原图
温度测量: 温度测量，使用测温仪表对物体的温度进行定量的测量。蒸气压温度计的测温精度高，装置较为复杂，但比气体温度计简单，在测温学实验中常用作标准温度计。温度测量，使用测温仪表对物体的温度进行定量的测量
控制电机: 《控制电机》是2011年机械工业出版社出版的图书，作者是杨渝钦。伺服电动机是自动控制系统中具有特殊用途的电动机。伺服电动机是自动控制系统中具有特殊用途的电动机。书后附有附录，介绍了一些控制电机的有关特性和精度的测量方法。书中带*号部分可作为选学内容
jpg: JPEG 是与平台无关的格式，支持最高级别的压缩，不过，这种压缩是有损耗的。渐近式 JPEG 文件支持交错。JPEG 图片以24位颜色存储单个光栅图像。jpg全名是   JPEG
功能原理: 功能原理是前苏联科技书中常用的一条原理，中国的科技书中也曾引用过
player: ----因为CS1.5是半条命Half Life的MOD，两个游戏可以在游戏中相互进入对方的服务器，因此很多CS玩家不小心进入了半条命的游戏，而他们默认的名字都是player
12月24日: 12月24日是公历一年中的第358天（闰年第359天），离全年结束还有7天。1935年12月24日萧红出版《生死场》轰动上海文坛。1987年12月24日北京地铁折返线通车
转速: 转速(Rotational Speed或Rev)：做圆周运动的物体单位时间内沿圆周绕圆心转过的圈数，叫做转速，（与频率不同）。其国际标准单位为r/S （转/秒）或 r/min （转/分），也有表示为RPM (转/分，主要为日本和欧洲采用，我国采用国际标准)。当单位为r/S时，数值上与频率相等，即n=f=1/T，T为作圆周运动的周期
商家: 商家是指从事商业活动（生产、经营相关物品）的个人和各种组织的统称。有时也简单的理解为提供商品和服务的店铺
入睡: 入睡是汉语词汇，拼音rù shuì，意思是睡着
效果图: 效果图解是通过图片等传媒来表达作品所需要以及预期的达到的效果，从现代来讲是通过计算机三维仿真软件技术来模拟真实环境的高仿真虚拟图片，在建筑、工业等细分行业来看，效果图的主要功能是将平面的图纸三维化，仿真化，通过高仿真的制作，来检查设计方案的细微瑕疵或进行项目方案修改的推敲。效果图是通过图片等传媒来表达作品所需要以及预期的达到的效果，从现代来讲是通过计算机三维仿真软件技术来模拟真实环境的高仿真虚拟图片。效果图作为建筑师推敲设计的工具是无可替代的
物理量: 物理量是物理之中能测量的量，例如质量、体积，或者是测量通常以数和物理单位（通常使用国际单位制单位）的积表达的结果。物理量具有明确定义及其物理意义，可用各种方法对它进行测量，测量的结果用数值和物理量单位来表示。物理量的符号必须用斜体表示，符号后不附加圆点。物理量（physical quantity）是指   物理学中所描述的   现象、物体或物质可定性区别和定量确定的属性。物理量的特点为：①同类量必能相互比较，每一个量必能以量值定量描述
芯片: 指内含集成电路的硅片，体积很小，常常是计算机或其他电子设备的一部分。另有一种厚膜（thick-film）混成集成电路（hybrid integrated circuit）是由独立半导体设备和被动组件，集成到衬底或线路板所构成的小型化电路。前述将电路制造在半导体芯片表面上的集成电路又称薄膜（thin-film）集成电路
亮相: 戏曲的亮相有两个作用：一是向观众展示美丽的造型，二是便于拍摄剧照。还有在一段武打完毕，敌对双方也都各自亮相，而战败一方的“亮相”被称为“败式”。主要角色上场时、下场前，或者是一段舞蹈动作完毕后的一个短促停顿。“亮相”是一种戏曲上的表演动作
清扫: 清扫，亦作“ 清埽 ”
分工: 现代社会为了提高管理的专业化程度和工作效率，把组织的任务、目标分成各个层次，各个部门以及各个人的任务和目标，明确各个层次，各个部门乃至各个人应该做的工作以及完成工作的手段、方式和方法
连接电路: 连接电路一款益智小游戏，游戏大小为1126K。连接正负极，组成一个回路。同极不能相连，不能交叉
模拟信号: 或在一段连续的时间间隔内，其代表信息的特征量可以在任意瞬间呈现为任意数值的信号。优点：分辨率较高，高达24位。转换速率高，高于积分型和压频变换型ADC
覆盖率: 覆盖率是度量测试完整性的一个手段，是测试有效性的一个度量
一个太阳: 《一个太阳》是一首阿根廷现代诗歌，作者阿尔韦西娜·斯托尔尼。经历过爱情的历练诗人变得成熟，更渴望一份平实的爱情
下载: 浏览器不仅是WWW客户程序，同时也内嵌有FTP功能，可以作为FTP客户程序，用它可以从FTP服务器下载文件，也可以向FTP服务器上传（upload）文件。HTTP和FTP是两种网络传输协议的缩写，FTP是File Transportation Protocol（文件传输协议）的缩写，而HTTP则是Hyper Text Transportation Protocol（超文本传输协议）的缩写，它们是计算机之间交换数据的方式，也是两种最经典的文件下载方式。广义上说，凡是在屏幕上看到的不属于本地计算机上的内容，皆是通过“下载”得来
危害: 识别危害时应充分考虑人员、设备、材料、环境、方法五个方面和正常、异常、紧急三个状态。”《汉书·西域传上·罽宾国》：“险阻危害，不可胜言。”《南史·垣护之传》：“元徽末， 苍梧 凶狂，恒欲危害 高帝。吸烟的危害，吸烟不仅危害自己的身体，也会对他人造成伤害，也会产生不良社会影响。一定要引起注意
占座: 大多数“占座”是超出自己所应获得的资源去占有公共资源，在一定程度上是不道德的，违反社会公德的行为。因为大学招的学生越来越多，导致它的公共资源不够充沛，很多地方如图书馆、自习室有人满为患的趋势。“占座”，就是提前去教室或图书馆等一些公共场所占领座位的意思。“占座”是现代大学里产生并流行的一个新词汇
声源: 一切发声的物体都在振动。声源：声音是由物体的振动产生的。物理学中，把正在发声的物体叫声源。物理学中，把正在发声的物体叫声源。如：正在振动的声带、正在振动的音叉、敲响的鼓等都是声源
智能硬件: 智能硬件是继智能手机之后的一个科技概念，通过软硬件结合的方式，对传统设备进行改造，进而让其拥有智能化的功能。智能化之后，硬件具备连接的能力，实现互联网服务的加载，形成"云端"的典型架构，具备了大数据等附加价值。智能硬件是继智能手机之后的一个科技概念，通过软硬件结合的方式，对传统设备进行改造，进而让其拥有智能化的功能
区间: 区间在积分理论中起着重要作用，因为它们作为最"简单"的实数集合，可以轻易地给它们定义"长度"、或者说"测度"。在数学里，区间通常是指这样的一类实数集合：如果x和y是两个在集合里的数，那么，任何x和y之间的数也属于该集合。例如，由符合0 ≤ x ≤ 1的实数所构成的集合，便是一个区间，它包含了0、1，还有0和1之间的全体实数。区间的概念还可以推广到任何全序集T的子集S。区间也是区间算术的核心概念
小船: 担任中国第一届、第二届全国街舞大赛的裁判长及表演嘉宾。至今担任全国各大卫视重磅栏目及各类大型演唱会、艺术节、电影节等艺术总监及总导演。2004年创作了中国第一部街舞题材的音乐剧“灵魂秀”在北京先锋剧场连续上演10场。2012年创作大型舞蹈剧《篮球梦》，担任总导演及舞蹈总监。连续两届担任“多彩贵州”大型舞蹈大赛多个舞种的总评委
红光: 红光，采用可见光600-700nm（占90%以上），红外光700-4000nm（占10%以下）的综合光波进行体外照射，使之产生重要的生物效应及治疗效果。果皮红褐色，油亮美观。果肉质地糯性，细糯香甜，果实耐贮藏
IR: 投资者关系管理(Investor Relations Managements，英文缩写为IRM)，有时也简称为投资者关系(Investor Relations，英文缩写为IR) 诞生于美国20世纪50年代后期，它包括上市公司（包括拟上市公司）与股东，债权人和潜在投资者之间的关系管理，也包括在与投资者沟通过程中，上市公司与资本市场各类中介机构之间的关系管理。科学家们将红外光谱分成三个区域：近红外波段，其能量和波长接近可见光，大约0.750～1.300μ（750～1300nm）。中红外波段，在1.300～3.000μ（1300～3000nm）范围内
潘越: 潘越是电视剧《神探狄仁杰》里的角色，在第二部登场，原为八大军头的龙兴军头，后调归狄仁杰麾下，为人智勇双全，屡建奇功，曾随狄仁杰攻破蛇灵总坛，但在第三部的黑衣社案子里，被“死亡之神”（变种蝙蝠）所杀，和齐虎搭档。主要作品有《密使》、《下一站，别离》、《我的爱情撞上了战争》、《致命名单》、《终极证据》、《零度较量》、《猎狼人》、《麻雀春天》、《我和妈妈走长征》等
如下: 如下，指如同下面所叙述或列举的
微信: 微信提供公众平台、朋友圈、消息推送等功能，用户可以通过“摇一摇”、“搜索号码”、“附近的人”、扫二维码方式添加好友和关注公众平台，同时微信将内容分享给好友以及将用户看到的精彩内容分享到微信朋友圈。微信用户可以通过智能手机客户端与好友分享文字与图片，并支持分组聊天和语音、视频对讲功能的智能型手机聊天软件。微信软件本身完全免费，使用任何功能都不会收取费用
液晶: 例如，液晶可以像液体一样流动（流动性），但它的分子却是像道路一样取向有序的（各向异性）。同时具有两种物质的液晶，是以分子间力量组合的，它们的特殊光学性质，又对电磁场敏感，极有实用价值。液晶的组成物质是一种有机化合物，也就是以碳为中心所构成的化合物。人们熟悉的物质状态（又称相）为气、液、固，较为生疏的是电浆和液晶。液晶的定义，现在已放宽而囊括了在某一温度范围可以是现液晶相，在较低温度为正常结晶之物质
应用层: 应用层与最低端的感知层一起，是物联网的显著特征和核心所在，应用层可以对感知层采集数据进行计算、处理和知识挖掘，从而实现对物理世界的实时控制、精确管理和科学决策。每个SASE提供特定的应用服务，例如文件运输访问和管理（FTAM）、电子文电处理（MHS）、虚拟终端协议（VAP）等。应用层也称为应用实体（AE），它由若干个特定应用服务元素（SASE）和一个或多个公用应用服务元素（CASE）组成。随着应用层的发展，各种特定应用服务的增多，应用服务的标准化开展了许多研究工作，ISO已制定了一些国际标准（IS）和国际标准草案（DIS）
电池组: 电池组，是指分串联和并联,并联的电池组要求每个电池电压相同,输出的电压等于一个电池的电压,并联电池组能提供更强的电流.串联电池组没有过多的要求。他把这些部件放在一起，制造出了第一个电池组
温度传感器: 温度传感器（temperature transducer）是指能感受温度并转换成可用输出信号的传感器。温度传感器（temperature transducer）是指能感受温度并转换成可用输出信号的传感器。温度传感器是温度测量仪表的核心部分，品种繁多。这些呈现规律性变化的物理性质主要有体
参展: 参展是出自于《游仙窟》的词语。2.参加展览
懒人: 据英国权威医学杂志《柳叶刀》发表报告称：在调查了全球122个国家后发现，全球三分之一的成年人是运动量不足的懒人，坐沙发、看电视等懒人生活方式每年致死约500万人，甚至每天久坐三小时就会减寿两年。懒人一般是指不爱劳动的人
后续: 后续，汉语词汇，释义为后嗣
LED驱动: LED是特性敏感的半导体器件，又具有负温度特性，因而在应用过程中需要对其进行稳定工作状态和保护，从而产生了驱动的概念。由于LED是特性敏感的半导体器件，又具有负温度特性，因而在应用过程中需要对其进行稳定工作状态和保护，从而产生了驱动的概念。LED器件对驱动电源的要求近乎于苛刻，LED不像普通的白炽灯泡，可以直接连接220V的交流市电。LED是2～3伏的低电压驱动，必须要设计复杂的变换电路，不同用途的LED灯，要配备不同的电源适配器。LED的恒流驱动
正整数: 正整数为大于0的整数。自然数中，除了0就是正整数。正整数又可分为素数，1和合数。正整数可带正号（+），也可以不带。正整数又可分为质数，1和合数
一笔画问题: 即平面上由曲线段构成的一个图形能不能一笔画成，使得在每条线段上都不重复。传统意义上的几何学是研究图形的形状大小等性质，而存在一些几何问题，它们所研究的对象与图形的形状和线段的长短没关系，而只和线段的数目和它们之间的连接关系有关，比如一笔画问题就是如此。两两相连区域可一笔画，例如，平面4个区域两两相连区域可一笔划。我们可以构造一个多维空间的无穷个两两相连区域一笔划
线性: f(x，y)*{ah(x，y)+bg(x，y)=af(x，y)*h(x，y)+bf(x，y)*g(x，y)。非线性non-linear则指不按比例、不成直线的关系，代表不规则的运动和突变，一阶导数不为常数。两个眼睛的视敏度是一个眼睛的几倍
这首歌: 《这首歌》讲述了对逝去恋情的惋惜和留恋，甜美的怀念、不舍的成全，用外表看似洒脱的快乐掩饰内心真正的忧伤
眼镜: 眼镜，以矫正视力或保护眼睛而制作的简单光学器件，由镜片、镜架组成。其他种类的眼镜包括护目镜，太阳镜，游泳镜等，为眼睛提供各种保护。眼镜可矫正多种视力问题，包括近视、远视、散光、老花或斜视等
打酱油: 打酱油，2008年度十大网络流行语之一。传统解释：以前的酱油都是零卖零买的，自己拿着瓶子到商店，你要多少，人家就给你称多少，这就叫打酱油。他说：关我鸟事我出来买酱油的。打酱油，2008年度十大网络流行语之一。传统解释：以前的酱油都是零卖零买的，自己拿着瓶子到商店，你要多少，人家就给你称多少，这就叫打酱油
全场: 全场全部在场者
OLED屏幕: OLED （Organic Light Emitting Display）即有机发光显示器，在手机LCD上属于新型产品，被称誉为“梦幻显示器”
BM: 工商管理专业缩写BM（business management）
单片机: 单片机（Microcontrollers）是一种集成电路芯片，是采用超大规模集成电路技术把具有数据处理能力的中央处理器CPU、随机存储器RAM、只读存储器ROM、多种I/O口和中断系统、定时器/计数器等功能（可能还包括显示驱动电路、脉宽调制电路、模拟多路转换器、A/D转换器等电路）集成到一块硅片上构成的一个小而完善的微型计算机系统，在工业控制领域广泛应用。单片机是指一个集成在一块芯片上的完整计算机系统。从上世纪80年代，由当时的4位、8位单片机，发展到现在的300M的高速单片机。它的最大优点是体积小，可放在仪表内部，但存储量小，输入输出接口简单，功能较低。从上世纪80年代，由当时的4位、8位单片机，发展到现在的32位300M的高速单片机
大数: 大数，有交易员术语，指汇率的头几位数字。还是印度佛教的数量单位。你不修德政，妄戮无辜，今日大数已尽，吾等专来报冤。数学用语，指两个数中较大的数
相关链接: 相关链接就是和你的网站内容，你的关键词相关的网站上留下你的链接
灰尘传感器: 可以感知烟草产生的烟气和花粉，房屋粉尘等1微米以上的微小粒子
责无旁贷: 出自清·文康《儿女英雄传》第十回：“讲到护送，除了自己一身之外，责堪旁贷者再无一人。但责无旁贷偏重于职责所需不能推卸，“义不容辞”偏重在道义上难以推托。责无旁贷（zé wú páng dài），指自己应尽的责任，不能推卸给旁人
IP地址: IP地址是IP协议提供的一种统一的地址格式，它为互联网上的每一个网络和每一台主机分配一个逻辑地址，以此来屏蔽物理地址的差异。IP地址是指互联网协议地址（英语：Internet Protocol Address，又译为网际协议地址），是IP Address的缩写。目前还有些ip代理软件，但大部分都收费。所谓IP地址就是给每个连接在Internet上的主机分配的一个32bit地址。IP地址（英语：Internet Protocol Address）是一种在Internet上的给主机编址的方式，也称为网际协议地址
对称加密算法: 收信方收到密文后，若想解读原文，则需要使用加密用过的密钥及相同算法的逆算法对密文进行解密，才能使其恢复成可读明文。收信方收到密文后，若想解读原文，则需要使用加密用过的密钥及相同算法的逆算法对密文进行解密，才能使其恢复成可读明文。在对称加密算法中，使用的密钥只有一个，发收信双方都使用这个密钥对数据进行加密和解密，这就要求解密方事先必须知道加密密钥。对称加密算法的特点是算法公开、计算量小、加密速度快、加密效率高。对称加密算法是应用较早的加密算法，技术成熟
游戏啦: 西安绝峰网络科技有限公司是一家新兴的高科技电子商务IT企业，主要运营专业性电子商务及网页游戏平台“游戏啦”（以下简称“游戏啦”）“游戏啦”成立于2012年6月，网站以拥有最具特色的国产页游产品为目标，以更贴心的客服服务用户为宗旨，正朝着国内前端页游平台迅速靠拢，致力于专项产品的游戏体验、新闻资讯、产品推广、论坛交流等方面，突出互动的表现方式，为玩家提供更便捷，更全面的服务。“游戏啦”以“游戏点缀生活 品质源于服务”为宗旨，通过多渠道、7×24的客服服务、充值服务，尽力为玩家打造优质的游戏体验
数据传送: 数据传送，是指在数据源和数据宿之间传送数据的过程，也称数据通信
blob: 但也有专家强调，这种处理大数据对象的方法是把双刃剑，它有可能引发一些问题，如存储的二进制文件过大，会使数据库的性能下降。在计算机中，BLOB常常是数据库中用来存储二进制文件的字段类型。BLOB是一个大文件，典型的BLOB是一张图片或一个声音文件，由于它们的尺寸，必须使用特殊的方式来处理（例如：上传、下载或者存放到一个数据库）。根据Eric Raymond的说法，处理BLOB的主要思想就是让文件处理器（如数据库管理器）不去理会文件是什么，而是关心如何去处理它。BLOB (binary large object)，二进制大对象，是一个可以存储二进制文件的容器
全国天气: 全国天气支持全国2515个市区县级七日内天气预报
电源适配器: 电源适配器（Power adapter）是小型便携式电子设备及电子电器的供电电源变换设备，一般由外壳、变压器、电感、电容、控制IC、PCB板等元器件组成，它的工作原理由交流输入转换为直流输出。广泛配套于电话子母机、游戏机、语言复读机、随身听、笔记本计算机、蜂窝电话等设备中。按连接方式可分为插墙式和桌面式
心形: “心形”是一种图案，它起源于中国的甲骨文的“心”字
位点: 位点（Locus：Loci as pl）：染色体上一个基因或者标记的位置。HpaII、NarI和SacII在某些底物的一些位点切割效率很低，或是干脆无法切开，其作用机制尚不明了。1975年，Thomas和Davis发现EcoRI并不是随机切割λDNA分子上的5个识别位点，其中对λDNA右侧位点的切割速率比中间位点快10倍
腾讯视频: 腾讯视频是中国领先的在线视频平台，拥有丰富的优质流行内容和专业的媒体运营能力，是聚合热播影视、综艺娱乐、体育赛事、新闻资讯等为一体的综合视频内容平台，并通过PC、移动及客厅产品等多种形态为用户提供高清流畅的视频娱乐体验，满足用户不同的体验需求[1-2]。同时以其极致的观看体验、便捷的登录方式、24小时多平台无缝应用体验以及快捷分享特性，满足用户在线观看视频的需求
聋哑人: 《聋哑人》是一本连载于起点中文网的小说，作者是东之玉
音频模块: E702T是一块ARM+DSP构架，专注于网络音频传输的控制模块，具有10/100M 以太网接口，可通过网络进行单向MP3音频流和双向语音传输
作品: 根据大多数国家的版权法（见著作权）和主要国际版权公约的规定，可以受版权保护的作品包括小说、诗词、散文、论文、速记记录、数字游戏等文字作品。摄影艺术作品。作品是指在文学和科学领域内，具有独创性并能以某种有形形式复制的智力创作成果
硬件系统: 所谓硬件系统，是指构成计算机的物理设备，即由机械、光、电、磁器件构成的具有计算、控制、存储、输入和输出功能的实体部件。系统设计已经成为一门重要的学科，传统的反复试验法已经越来越不适应时代的发展。软硬件协同设计技术越来越受到人们的重视
FFF团: 由于班级内部女生太少，并且不受到异性欢迎，便集体组成了FFF团，作为文月学园中学生间的审判法庭——异端审问会存在，每当收到来自学校内其他学生的举报申诉时便会召开会议进行审问或者判刑。全名"异端审问会·FFF团"。FFF团是私立文月学园高中部二年级F班的一个异端审判组织
器件: 电子、电工仪器上能独立起控制变换作用的单元，常有几个元件组成，有时也指较大的元件。例如晶体管、电子管、集成电路。按分类标准，电子器件可分为12个大类，可归纳为真空电子器件和半导体器件两大块
绿色: 绿色是电磁波的可视光部分中的中波长部分，波长为492～577纳米，绿色是大自然界中常见的颜色。绿色是大自然界中常见的颜色。绿色是电磁波的可视光部分中的中波长部分，波长大约为500～570nm，光的三原色之一
二极管: 在半导体二极管内部有一个PN结两个引线端子，这种电子器件按照外加电压的方向，具备单向电流的传导性。当外加电压等于零时，由于p-n 结两边载流子的浓度差引起扩散电流和由自建电场引起的漂移电流相等而处于电平衡状态，这也是常态下的二极管特性。一般来讲，晶体二极管是一个由p型半导体和n型半导体烧结形成的p-n结界面。[1]几乎在所有的电子电路中，都要用到半导体二极管，它在许多的电路中起着重要的作用，其应用也非常广泛。二极管又称晶体二极管,简称二极管(diode)，另外，还有早期的真空电子二极管
物联网: 物联网通过智能感知、识别技术与普适计算等通信感知技术，广泛应用于网络的融合中，也因此被称为继计算机、互联网之后世界信息产业发展的第三次浪潮。这有两层意思：其一，物联网的核心和基础仍然是互联网，是在互联网基础上的延伸和扩展的网络。其英文名称是：“Internet of things（IoT）”。物联网是   互联网的应用拓展，与其说物联网是网络，不如说物联网是业务和应用。顾名思义，物联网就是物物相连的互联网
高频: 高频及感应加热技术目前对金属材料加热效率最高、速度最快，且低耗环保。因此，感应加热技术必将在各行各业中应用越来越广泛。可实现工件的深层透热，也可只对其表面、表层集中加热。因此，感应加热技术必将在各行各业中应用越来越广泛。可实现工件的深层透热，也可只对其表面、表层集中加热
老师: 传授知识和科学的人称为老师，也泛指在某方面值得学习能够给大家带来一定正确知识和指导的有能力人。《师说》中：“师者，所以传道受业解惑[也。老师，尊称传授文化、技术的人，泛指在某方面值得学习的人。教师的概念：在各级各类学校中，以教育培养学生（学员）为职责的专业工作者
电磁炮: 与传统大炮将火药燃气压力作用于弹丸不同，电磁炮是利用电磁系统中电磁场产生的洛伦兹力来对金属炮弹进行加速，使其达到打击目标所需的动能，与传统的火药推动的大炮，电磁炮可大大提高弹丸的速度和射程。电磁炮：是利用电磁发射技术制成的一种先进动能杀伤武器
电器: 电器（electrical appliance）泛指所有用电的器具，从专业角度上来讲，主要指用于对电路进行接通、分断，对电路参数进行变换，以实现对电路或用电设备的控制、调节、切换、检测和保护等作用的电工装置、设备和元件。电器是总称，电是指：交流电、直流电、高压电、低压电。但现在这一名词已经广泛的扩展到民用角度，从普通民众的角度来讲，主要是指家庭常用的一些为生活提供便利的用电设备，如电视机，空调，冰箱，洗衣机，各种小家电等等
漫漫长夜: 漫漫长夜是《侠盗猎车手：罪恶都市》的一种MOD补丁，英文名为Long Night。《廊桥遗梦》的故事曾经感动全世界数以亿计的读者观众，由此改编的同名大片被评为当年最具影响力的十部影片之一，在国内亦引起一阵“廊桥热”。罗伯特·吉姆斯·沃勒，现居得克萨斯州的丘陵地区，在那儿孜孜不倦地钻研经济、数学、摄影和音乐
电路设计: 电路设计，是指按照一定规则，使用特定方法设计出符合使用要求的电路系统
俄罗斯: 俄罗斯位于欧亚大陆北部，地跨欧亚两大洲，国土面积为1707.54万平方公里，是世界上面积最大的国家，也是一个以俄罗斯人为主体民族，由193个民族构成的统一多民族国家，俄罗斯人占总人口的81%。俄罗斯2015年陷入经济危机，经济衰退预计超过3.7%俄罗斯近年来加强了与独联体各国的一体化，最为突出的是俄效仿欧盟模式，与白俄罗斯、哈萨克斯坦、亚美尼亚于2015年建立的欧亚联盟。俄罗斯有十四个陆上邻国，分别为：挪威、芬兰、爱沙尼亚、拉脱维亚、立陶宛、波兰、白俄罗斯、乌克兰、格鲁吉亚、阿塞拜疆、哈萨克斯坦、中华人民共和国、蒙古、朝鲜（其中立陶宛和波兰仅与俄罗斯外飞地的加里宁格勒州接壤）。1991年，苏联解体，俄罗斯继承苏联成为联合国安全理事会五大常任理事国，对安理会议案拥有否决权。国旗为白、蓝、红三色旗
page: Page为计算机编程语言脚本，定义JSP文件中的全局属性。指令不能作用于动态的包含文件，比如你可以在一个页面中用上多个。Page为计算机编程语言脚本，定义JSP文件中的全局属性
遍历: 所谓遍历(Traversal)，是指沿着某条搜索路线，依次对树中每个结点均做一次且仅做一次访问。程序代码上的意思是指沿着某条搜索路线，依次对树中每个结点均做一次且仅做一次访问，访问结点所做的操作依赖于具体的应用问题。所谓遍历(Traversal)，字面意思是遍历就是全部走遍，到处周游的意思。遍历是二叉树上最重要的运算之一，是二叉树上进行其它运算之基础
科技人员: 广义上来说是掌握一项相关技术的人才，可以是具有农、林、电、工、理、医、法、经济等各个学科领域相关技术的人才
接线图: 描述系统中设备与线缆连接的图纸，如：1 采用怎样的线缆，2 线缆中的每一条线如何端接，端接到设备的哪一个接线柱上，3 通常会包含设备自身的供电电源线，系统总线，信号的输入线，设备自身状态的反馈线，对外部设备的控制线和电源线等。表示成套装置、设备或装置的电路连接关系的简图
接口: 在计算机中，接口是计算机系统中两个独立的部件进行信息交换的共享边界。有的产品还具有麦克风的接口，可以把外部的声音通过MD录制下来。而目前的NetMD产品还应具有USB接口，这样才能够和电脑相连接，从而能够进行文件的传输。电脑等信息机器硬件组件间的接口叫硬件接口。电脑等信息机器软件组件间的接口叫软件接口
食堂: 食堂是指设于机关、学校、厂矿等企事业单位、为供应其内部职工、学生等就餐的非盈利性场所。食堂是指设于机关、学校、厂矿等企事业单位、为供应其内部职工、学生等就餐的非盈利性场所。那是政治疯狂来临时，农民用装穷的办法对抗这种疯狂已经完全没有效力了，所以兴办公共食堂只是成为一系列浪漫主义狂热举动中的一项。人们在公共食堂领馒头，吃饭，食堂刚开始的时候很“兴旺”
端口: 物理端口又称为接口，是可见端口，计算机背板的RJ45网口，交换机路由器集线器等RJ45端口。物理端口又称为接口，是可见端口，计算机背板的RJ45网口，交换机路由器集线器等RJ45端口。端口可分为虚拟端口和物理端口，其中虚拟端口指计算机内部或交换机路由器内的端口，不可见
小东西: 《小东西》半自传式地记叙了作者青少年时期因家道中落，不得不为生计而奔波的经历，以俏皮和幽默的笔调描绘资本主义社会人与人之间的冷酷关系。这部小说是都德的代表作，它集中表现了作者的艺术风格，不带恶意的讽刺和含蓄的感伤，也就是所谓含泪的微笑
zigbee: ZigBee协议从下到上分别为物理层(PHY)、媒体访问控制层(MAC)、传输层(TL)、网络层(NWK)、应用层(APL)等。ZigBee是基于IEEE802.15.4标准的低功耗局域网协议。根据国际标准规定，ZigBee技术是一种短距离、低功耗的无线通信技术。简而言之，ZigBee就是一种便宜的，低功耗的近距离无线组网   通讯技术。这一名称（又称紫蜂协议）来源于蜜蜂的八字舞，由于蜜蜂(bee)是靠飞翔和“嗡嗡”(zig)地抖动翅膀的“舞蹈”来与同伴传递花粉所在方位信息，也就是说蜜蜂依靠这样的方式构成了群体中的通信网络
吴一: 吴一，从事美容整形外科20余年，具有丰富的美容整形外科临床经验
腾出: 腾出是一个汉语词汇，拼音是téng chū，指使空出来
剪辑: 剪辑(Film editing)，即将影片制作中所拍摄的大量素材，经过选择、取舍、分解与组接，最终完成一个连贯流畅、含义明确、主题鲜明并有艺术感染力的作品。从美国导演格里菲斯开始，采用了分镜头拍摄的方法，然后再把这些镜头组接起来，因而产生了剪辑艺术。剪辑既是影片制作工艺过程中一项必不可少的工作，也是影片艺术创作过程中所进行的最后一次再创作。中国著名的剪辑师有战海红、麦子善、林安儿等
ADC0809: ADC0809是美国国家半导体公司生产的CMOS工艺8通道，8位逐次逼近式A/D模数转换器。ADC0809是美国国家半导体公司生产的CMOS工艺8通道，8位逐次逼近式A/D模数转换器。其内部有一个8通道多路开关，它可以根据地址码锁存译码后的信号，只选通8路模拟输入信号中的一个进行A/D转换。目前这种工艺已经被淘汰
一晚: 《一晚》是由香港歌手麦洁文演唱的歌曲，由林振强作词，张国荣作曲
合唱: 合唱（hé chàng）chorus指集体演唱多声部声乐作品的艺术门类，常有指挥，可有伴奏或无伴奏。它要求单一声部音的高度统一，要求声部之间旋律的和谐，是普及性最强、参与面最广的音乐演出形式之一。人声作为合唱艺术的表现工具，有着其独特的优越性，能够最直接地表达音乐作品中的思想情感，激发听众的情感共鸣
胶带: 胶带表面上涂有一层粘着剂，才能令胶带粘住物品，最早的粘着剂来自动物和植物，在十九世纪，橡胶是粘着剂的主要成份。人们为这种胶带找到了几百种用途，从补衣服到保护碰破的鸡蛋它都大有用途。1928年在美国明尼苏达圣保罗，理查·德鲁发明了透明胶带
云虚拟主机: 近年来，随着互联网IDC事业的发展，云平台逐渐成为互联网事业发展的核心，从大数据平台，到各种云服务中心，延伸至各大网络巨头的云服务器，但就目前来看，其真正实现云产品服务的企业并不多见，其主要原因就是，投资成本过大，就全国来说如果在东北、华北、华东、华南、西南、西北、边疆等地设立10个云平台分布中心，每个节点，上千台服务器和几十G的网络出口，并非一般企业所能及。为了不断满足企业信息化需求，和互联网事业的日益发展，各种互联网商业活动的需求，特别是中小型企业和站长的需求，互联网云虚拟主机倡导者创新网络在2013年8月特别推出满足中小型企业信息化需求的云虚拟主机。就实力较雄厚的阿里巴巴推出的阿里云来看，也就仅仅完成了华东的云平台布局，可以说，并不能真正称之为云数据中心或者云服务器
USB数据线: USB数据线用于电脑与外部设备的连接和通讯，也可用于手机的充电和与外部的连接。方便携带，传输数据快捷稳定。通俗的说，用于传数据和充电
频率: 频率，是单位时间内完成周期性变化的次数，是描述周期运动频繁程度的量，常用符号f或ν表示，单位为秒分之一，符号为s-1。为了纪念德国物理学家赫兹的贡献，人们把频率的单位命名为赫兹，简称“赫”。每个物体都有由它本身性质决定的与振幅无关的频率，叫做固有频率。频率概念不仅在力学、声学中应用，在电磁学和无线电技术中也常用
音乐: 音乐是反映人类现实生活情感的一种艺术（英名称：music。音乐也是反映人类现实生活情感的一种艺术（英文名称：music。音乐从历史发展上可分为中国古代音乐和西方音乐。音乐不仅是艺术门类的一脉，也是作为人类的一种社会现象，是伴随着人类的出现而产生的，是人类社会发展到一定阶段的产物。在所有的艺术类型中，音乐是最抽象的艺术，现实生活中还有用音乐来减轻或消除患者病痛的音乐疗法
调试程序: 开或关闭游戏出现内存不能为的提示，说明这个游戏与系统中其他的程序有冲突的地方，建议在玩游戏的时候关闭一切程序包括杀毒软件，和暂时关闭杀毒软件的监控功能和其他带有监控功能的程序。如果还经常出现错误的提示，将这个游戏卸载，再重新下载安装新版游戏即可
for: 有时候把这种形式称为增强的for(enhanced for)语句，它可以使循环更加紧凑和容易阅读。初始化总是一个赋值语句，它用来给循环控制变量赋初值。编程中用于循环处理的语句
小屋: 虽然帝国为了根除曾经保卫银河系的绝地武士团（Jedi order）的一切残余花费了大量的精力，但他们忽略了这个粗陋的住所是可以理解的。那是一个简朴的小屋，坐落在沙海（Dune Sea）深处的一个宁静的小山岗上。欧比-旺·克诺比（Obi-Wan Kenobi）在塔图因（Tatooine）的住所是绝地在帝国（Empire）时期的最后一个资料库之一
智能小车: 控制器部分：接收传感器部分传递过来的信号，并根据事前写入的决策系统（软件程序），来决定机器人对外部信号的反应，将控制信号发给执行器部分。智能小车作为现代的新发明，是以后的发展方向，他可以按照预先设定的模式在一个环境里自动的运作，不需要人为的管理，可应用于科学勘探等等的用途。智能小车能够实时显示时间、速度、里程，具有自动寻迹、寻光、避障功能，可程控行驶速度、准确定位停车，远程传输图像等功能。好比人的眼睛、耳朵等感觉器官
便签: 一种小型的便于携带的纸，有的一面有黏性，多是黄色的，为了迎合年轻人的喜好，也出现了其他鲜艳的颜色，用来随时记下一些内容，如写便条，电话号码等。几十或几百张形成一叠，可随处粘贴，方便提醒使用者有关问题、想法、指示等事情。市面便签大致由三种形式构成，小便签，中便签，创意便签共同组成了便签市场
报警器: 随着科技的进步，机械式报警器越来越多地被先进的电子报警器代替，经常应用于系统故障、安全防范、交通运输、医疗救护、应急救灾、感应检测等领域，与社会生产密不可分。如：门磁感应器和煤气感应报警器。如有盗匪撬门，门磁感应器会即刻将此信息传输给家庭报警主机，主机报警，将此信息传输到控制中心，中心会立即显示报警地点、性质（门盗）。报警器，分为机械式报警器和电子报警器
数字原理: 数字原理，作者，陈文楷 徐萍萍，2002-2科学出版社出版
概览: 谓概略地观览
ROW: 类似的词包括：APEJ（the Asia and Pacific excluding Japan）。ROW(reference) Reference 为需要得到其行号的单元格或单元格区域
开源: 但是软件的作者显然必须能够自我认证、在适当的时刻确认他们的软件是按照OSI Certified的开放源代码方式发布的。人们需要知道的是组成软件的包和它们的许可证是开放的源代码
摘要: 具体地讲就是研究工作的主要对象和范围，采用的手段和方法，得出的结果和重要的结论，有时也包括具有情报价值的其它重要的信息。摘要一般只用二三句话概括论文的主题和结论,通常不涉及具体的数据和方法，多用于综述,会议报告等。该类摘要通常具有独立性和自含性，可用于帮助潜在的读者来决定是否需要阅读全文。摘要又称概要、内容提要
小和尚讲故事: 《小和尚讲故事》是2009年河南文艺出版社出版的图书，作者是释戒嗔
火柴人跑酷: 火柴人跑酷 Stickman Run 跑酷与火柴人的完美结合，当火柴人也来玩跑酷的时候，会发生什么呢
视觉盛宴: 《视觉盛宴》，是兵器工业出版社2007年出版的图书，作者是林刚
预警: 预警是指在灾害或灾难以及其他需要堤防的危险发生之前，根据以往的总结的规律或观测得到的可能性前兆，向相关部门发出紧急信号，报告危险情况，以避免危害在不知情或准备不足的的情况下发生，从而最大程度的减轻危害所造成的损失的行为。预警信息发布单位要密切关注事件进展情况，并依据事态变化情况和专家顾问组提出的预警建议，适时调整预警级别，并将调整结果及时通报各相关部门
简单游戏: 《简单游戏》是一款休闲小游戏，游戏中使用鼠标点击操作
保护视力: 据报道，中国人群中近视眼的患病率非常高，而且近视人群有越来越年幼化趋势。三是光线会快速变化（如早晚的阳光，多云天气、或阴/雨变化时的自然光）。据报道，中国人群中近视眼的患病率非常高，而且近视人群有越来越年幼化趋势
访问: 与其他方法相比，访问的最大特点是通过交谈获取资料，可以作为搜集研究所需资料的主要方法，也可以作为辅助方法去验证或补充其他方法获得的资料。当研究对象的构成成分较复杂时，访问能较快地了解不同人员的情况。社会调查中以交谈方式搜集资料的一种方法。它适用于研究较复杂的问题，或对问题进行深入的探索
程序调试: 程序调试，是将编制的程序投入实际运行前，用手工或编译程序等方法进行测试，修正语法错误和逻辑错误的过程。根据测试时所发现的错误，进一步诊断，找出原因和具体的位置进行修正。这是保证计算机信息系统正确性的必不可少的步骤
面了: 释义：面，在北方方言中，用以形容人时，意指像面团一样被揉来揉去，有太窝囊、不果断、软弱无能、犹犹豫豫等含义
承受载荷: 机械设计中通常指施加于机械或结构上的外力。另外，有时也把某种能引起机械结构内力的非力学因素称为载荷。动力机械中通常指完成工作所需的功率
介绍: 见清 袁枚《随园诗话补遗》卷六：“余与和希斋 大司空，全无介绍，而蒙其矜宠特隆。推荐3. 使了解
感谢: 感谢：是一个人在获得他人的帮助、接受他人给予的鼓励或他人提供的方便、恩惠、利益，使自己得到提高、进步、完善、圆满、成功之后，出于内心的感激之情，用言行向对方表达谢意的行为。2013年张靓颖发行的公益碟，《感谢》公益EP限量发行，除了收录WWF“留住江豚的微笑”活动主题曲《感谢》，还特别将2012年底至今张靓颖尚未实体发行的4首单曲收录其中，以回馈所有歌迷的支持。整张EP秉持环保概念，以环保材质为包装，特别附赠三张感谢明信卡，以鼓励大家积极传递“感谢的力量”
花儿: “花儿”是流传在中国西北部甘、青、宁三省（区）的汉、回、藏、东乡、保安、撒拉、土、裕固、蒙古等民族中共创共享的民歌。国家非常重视非物质文化遗产的保护，2006年5月20日，花儿经国务院批准列入第一批国家级非物质文化遗产名录
摩尔斯电码: 摩尔斯电码（又译为摩斯密码，Morse code）是一种时通时断的信号代码，通过不同的排列顺序来表达不同的英文字母、数字和标点符号。它发明于1837年，发明者有争议，是美国人塞缪尔•莫尔斯或者艾尔菲德•维尔。摩尔斯电码是一种早期的数字化通信形式，但是它不同于现代只使用零和一两种状态的二进制代码，它的代码包括五种：点、划、点和划之间的停顿、每个字符间短的停顿（在点和划之间）、每个词之间中等的停顿以及句子之间长的停顿
声音传感器: 它用来接收声波，显示声音的振动图象
小球: 小球，释义为小的圆形物体，汉语词汇
起源: 字者人所制也，列象数而成字形，乃斯文之起源。《起源》的任务具有非常强的向导性，一个玩家从进入游戏世界开始就会被任务所引导，初步认识自己的职业以及周围的环境，当玩家熟悉了这一切之后，会通过任务的方式引导玩家到最适合的游戏区域。语出田北湖《论文章源流》：“象者天所生也，数者物所呈也
系统结构: 系统结构，是指系统内部各组成要素之间的相互联系、相互作用的方式或秩序，即各要素在时间或空间上排列和组合的具体形式。系统结构也用来表述对计算机系统中各级机器间界面的划分和定义，以及对各级界面上、下的功能进行分配。从最基本的意义来说，系统是由相互关联的元素构成的
智能眼镜: 智能眼镜，也称智能镜，是指“像智能手机一样，具有独立的操作系统，可以由用户安装软件、游戏等软件服务商提供的程序，可通过语音或动作操控完成添加日程、地图导航、与好友互动、拍摄照片和视频、与朋友展开视频通话等功能，并可以通过移动通讯网络来实现无线网络接入的这样一类眼镜的总称”
Processing: 《Processing》是2007年9月28日MIT Press出版社出版的图书，作者是Casey Reas / Ben Fry。Processing的应用非常丰富，而且它们全部遵守开放源代码的规定，这样的设计大幅增加了整个社群的互动性与学习效率。以Processing完成的作品可在个人本机端作用，或以Java Applets的模式外输至网络上发布。它的概念是在电子艺术的环境下介绍程序语言，并将电子艺术的概念介绍给程序设计师。Processing可以在Windows、MAC OS X、MAC OS 9 、Linux 等操作系统上使用
电阻应变式传感器: 电阻应变式传感器由弹性敏感元件、电阻应变计、补偿电阻和外壳组成，可根据具体测量要求设计成多种结构形式。原理是弹性敏感元件受到所测量的力而产生变形，并使附着其上的电阻应变计一起变形。电阻应变式传感器由弹性敏感元件、电阻应变计、补偿电阻和外壳组成。电阻应变式传感器（straingaugetypetransducer）以电阻应变计为转换元件的电阻式传感器
大科技: 大科技杂志创刊于1997年，是我国目前第一本以开拓思维、激发好奇心、丰富想象力为宗旨的科普杂志。大科技杂志创刊于1997年，主管单位海南省科学技术厅
源码: 人们平时使用软件时就是程序把“源码”翻译成我们可直观的形式表现出来供我们使用的。任何一个网站页面，换成源码就是一堆按一定格式书写的文字和符号，但我们的浏览器帮我们翻译成眼前的模样了。音乐家用五线谱，建筑师用图纸，那程序员的工作的语言就是“源码”了。运行的软件是要经过编写的，程序员编写程序的过程中需要他们的“语言”。源码就是指编写的最原始程序的代码
可移植性: 为获得较高的可移植性，在设计过程中常采用通用的程序设计语言和运行支撑环境。软件可移植性指与软件从某一环境转移到另一环境下的难易程度
输入输出接口: 计算机输入输出接口是CPU与外部设备之间交换信息的连接电路，它们通过总线与CPU相连，简称I/O接口。I/O接口分为总线接口和通信接口两类
水泵: 叶片泵是利用回转叶片与水的相互作用来传递能量，有离心泵、轴流泵和混流泵等类型。它将原动机的机械能或其他外部能量传送给液体，使液体能量增加，主要用来输送液体包括水、油、酸碱液、乳化液、悬乳液和液态金属等，也可输送液体、气体混合物以及含悬浮固体物的液体。根据不同的工作原理可分为容积水泵、叶片泵等类型。水泵性能的技术参数有流量、吸程、   扬程、轴功率、水功率、效率等。容积泵是利用其工作室容积的变化来传递能量
炫彩: 原为闪耀光彩之义，现在也可以解释为炫丽多彩，多用以形容女性妆容或产品的显示效果，也可以形容某些自然或人工景观（如烟花）所带来的视觉感受
可穿戴设备: 可穿戴设备不仅仅是一种硬件设备，更是通过软件支持以及数据交互、云端交互来实现强大的功能，可穿戴设备将会对我们的生活、感知带来很大的转变。可穿戴设备即直接穿在身上，或是整合到用户的衣服或配件的一种便携式设备
简要: 简要，汉语词汇
暂定: 暂定是一个汉语词语，拼音是zàn dìng，意思是1.暂时安排的。如：学习期限暂定两年。暂时或临时提供的
便携式: 便携式是汉语词语，拼音为biàn xié shì，释义为便于携带的。性能，因此目前大多数设计者都使用集成的EMI滤波器。便携式就是指便于携带的,大都具备体积小、操作容易、携带方便等特点
室友: 室友 住在同一个房间（一般是学校，单位的集体宿舍，寝室，或者共同租房同室居住）的人们，他（她）们就是室友关系。台湾私立东海大学有一栋10层楼的学生宿舍，1999年开始采取男女同宿，1—5楼为男宿舍，6—10楼为女宿舍，但有门禁管制，女生可搭电梯上楼，男生无法进入，同时一二楼设有交谊厅。室友是指住在同一个房间（一般是学校，单位的集体宿舍，寝室，或者共同租房同室居住）的人们，共同生活但无亲属、血缘、婚姻及性关系的人，他们就是室友关系
width: 3.在html语言中，width表示数据视图中单元格变量值的宽度。在 spss中width表示数据视图中 单元格变量值的宽度，如果单元格变量值位数大于所设定的宽度，该单元格将出现乱码。1.[英][wɪdθ] [美][wɪdθ, wɪθ, wɪtθ]width n.宽度。1.[英][wɪdθ][美][wɪdθ,wɪθ,wɪtθ]widthn.宽度。4.在c++语言中
特诺: 特诺是爱沙尼亚足球运动员，效力于塔梅卡俱乐部
扇叶: 扇叶，台扇和吊扇的组成成分，通过电机带动，转动以产生风的部件
FED: FED---Field Emission Display (or Field Effection Display) 是指所谓电子发射是指电子从阴极逸出进入真空或其它气体媒质中的过程
下手太重: 好好听谢霆锋——睽违一年，集结港台音乐精英，霆锋全心投入音乐新纪元。鲜烈的音乐直觉，撼动全亚洲的听觉。好好听谢霆锋
https: HTTPS（全称：Hyper Text Transfer Protocol over Secure Socket Layer），是以安全为目标的HTTP通道，简单讲是HTTP的安全版。即HTTP下加入SSL层，HTTPS的安全基础是SSL，因此加密的详细内容就需要SSL。https:URL表明它使用了HTTP，但HTTPS存在不同于HTTP的默认端口及一个加密/身份验证层（在HTTP与TCP之间）。这个系统的最初研发由   网景公司(Netscape)进行，并内置于其浏览器Netscape Navigator中，提供了身份验证与加密   通讯方法。用于安全的HTTP数据传输
诞生了: 《诞生了》，音乐专辑，拇指姑娘乐队“成长三部曲”之一
空调: 末端装置则负责利用输配来的冷热量，具体处理空气，使目标环境的空气参数达到要求。空调即空气调节（air conditioning），是指用人工手段，对建筑/构筑物内环境空气的温度、湿度、洁净度、速度等参数进行调节和控制的过程。一般包括冷源/热源设备，冷热介质输配系统，末端装置等几大部分和其他辅助设备
数字信号: 或者说，只要能把解决问题的方法用数学公式表示，就能用计算机来处理代表物理量的数字信号。数字信号指幅度的取值是离散的，幅值表示被限制在有限个数值之内。由于数字信号是用两种物理状态来表示0和1的，故其抵抗材料本身干扰和环境干扰的能力都比模拟信号强很多。在计算机中，数字信号的大小常用有限位的二进制数表示，例如，字长为2位的二进制数可表示4种大小的数字信号，它们是00、01、10和11。若信号的变化范围在-1~1，则这4个二进制数可表示4段数字范围，即[-1, -0.5)、[-0.5, 0)、[0, 0.5)和[0.5, 1]
听力障碍: 听力障碍（dysaudia）是指听觉系统中的传音、感音以及对声音的综合分析的各级神经中枢发生器质性或功能性异常，而导致听力出现不同程度的减退。由外耳、中耳病变引起的听力障碍为传导性耳聋，如耵聍栓塞、耳咽管阻塞、急慢性中耳炎等引起的听力障碍均属此类。上述过程中任何部位的病变，均可引起听力障碍。习惯称为耳聋（deafness）
无线: 例如：无线网络 (如“无线网桥、无线AP”）、电视广播有限公司 (又称“无线电视台”)。一般来说，“无线”指的是无线电或无线电波，通信领域范畴。无线英文：wireless
OLED显示屏: 有机电激发光二极管由于同时具备自发光，不需背光源、对比度高、厚度薄、视角广、反应速度快、可用于挠曲性面板、使用温度范围广、构造及制程较简单等优异之特性，被认为是下一代的平面显示器新兴应用技术。中国OLED产业前景非常广阔，业内企业也正在努力积累发展经验，但国内产业链上游环节薄弱，行业的配套能力欠缺等因素为广大厂商制造了比较大的发展障碍。由于同时具备自发光，不需背光源、对比度高、厚度薄、视角广、反应速度快、可用于挠曲性面板、使用温度范围广、构造及制程较简单等优异之特性，被认为是下一代的平面显示器新兴应用技术
连横: 连横，战国时期的外交策略，出自“诸子百家”中的纵横家，与“合纵”对应，也作连衡
N5: 日本语能力测试(JLPT：The Japanese-Language Proficiency Test)是由日本国际交流基金会及日本国际教育支援协会于1984年建立的一套较为完整的考试评价体系。报名费将采用网上支付的形式，目前仅支持中国工商银行和中国招商银行，考生在报名前需要办理中国工商银行的银行卡或中国招商银行的银行卡，并开通网上支付功能
原版: 原版，读音yuán bǎn，汉语词语，解释为原来指印刷品的最初版本。语出柯岩 《美的追求者·花开花谢》：“原来那全是画。也特指未经翻译的原作
灵感: 通常搞创作的学者或科学家常常会用灵感一词来描述自己对某件事情或状态的想法或研究。具有情绪性，灵感降临时，人的心情是紧张的、高度兴奋，甚至陷入迷狂的境地。全社会要树立灵感就是宝贵创新资源的观念
阶乘: 阶乘是基斯顿·卡曼（Christian Kramp，1760～1826）于 1808 年发明的运算符号，是数学术语。通常我们所说的阶乘是定义在自然数范围里的（大多科学计算器只能计算0~69的阶乘）。但是，有时候我们会将Gamma函数定义为非整数的阶乘，因为当x是正整数n的时候，Gamma函数的值是n-1的阶乘。自然数n的阶乘写作n。1808年，基斯顿·卡曼引进这个表示法
歌词: 入乐的歌在感情抒发、形象塑造上和诗没有任何区别，但在结构上、节奏上要受音乐的制约，在韵律上要照顾演唱的方便，在遣词炼字上要考虑听觉艺术的特点，因为它要入乐歌唱。歌词是诗歌的一种，入乐的叫歌，不入乐的叫诗（或词）。歌词与诗的分别，主要是诗不一定要入乐（合乐），歌词是要合乐的。中国古代的宋词、元曲均是一种歌词，除独立吟诵外，亦可以配合歌曲，以当时的汉字发音唱出。可惜现时大部分曲谱已失传，而且因语音变化相当大，古人亦无录音设备，才使今人难以把这些词曲咏唱出来
太阳升起: 浪花兄弟（The Drifters），台湾音乐团体，由邱凯伟和杨常青所组，于2010年3月成立发行首张专辑，现为杰威尔音乐旗下的艺人。作曲:是周杰伦，小说太阳升起的作者是廖东明出版社和人民文学出版社。太阳升起的歌手是浪花兄弟，是作词:darren、常青
论坛: 它是一种交互性强，内容丰富而及时的Internet电子信息服务系统，用户在BBS站点上可以获得各种信息服务、发布信息、进行讨论、聊天等等。论坛（forum），又名网络论坛，是Internet上的一种电子信息服务系统。它是一种交互性强，内容丰富而即使的Internet电子信息服务系统。是Internet上的一种电子信息服务系统。著名的论坛有：世界经济论坛，联合国人权论坛，财富全球论坛，博鳌亚洲论坛，世界社会论坛等
下一个: 《下一个》面向每一位智能手机用户，以接地气式的绝佳体验服务，提供精品智能科技内容，涉及手机、互联网、手机应用、图书、游戏等众多生活相关领域
式子: 式子，指算式、代数式、方程式等的统称
原理: 是在大量观察、实践的基础上，经过归纳、概括而得出的。孟伟哉《一座雕像的诞生》第一章：“他们六个人，在没有路的山野里，凭着方向，按直线最短的原理，跌撞疾行。【释义】：自然科学和社会科学中具有普遍意义的基本规律
回家的路: 影片讲述了一个平凡的韩国主妇在法国奥利机场被误会藏毒，被囚禁在距离韩国飞行时间长达22个小时才能到达的、位于马丁尼克岛的监狱，以及为了救出妻子而向全世界求助的丈夫之间展开的真实的故事。刘德华2015最新单曲回家的路全新发布。《回家的路》这首歌的歌词由刘德华本人亲自操刀
其他功能: MP3播放器除了播放MP3等格式的音乐外，还具有FM调频、录音功能、移动存储，除此之外，还有许多附加的功能
授权: 即主管将处理用人、用钱、做事、交涉、协调等决策权移转给部属，只授予权力，不可托付完成该项工作的必要责任，这是授权的绝对原则性。授权是组织领导者重要技能之一，CEO必读12篇聚焦授权等企业管理领域，快速提升CEO自身领导力及管理能力籍此达到推动企业成长的目的。有效的授权是一项重要的管理技巧。授权是组织领导者的重要技能之一，有效的授权是一项重要的管理技巧。若授权得当，所有参与者均可受惠
餐饮: 餐饮业（catering）是通过即时加工制作、商业销售和服务性劳动于一体，向消费者专门提供各种酒水、食品，消费场所和设施的食品生产经营行业。餐饮业 catering .是通过即时加工制作、商业销售和服务性劳动于一体，向消费者专门提供各种酒水，食品，消费场所和设施的食品生产经营行业。其主要内容是，从事该行业的组织（如餐厅、酒店、食品加工厂）或个人，通过对食品进行加工处理，满足食客的饮食需要，从而获取相应的服务收入
1984年: 农历甲子年（鼠年），闰十月，共384天。1984年是一个闰年，共366天。农历是甲子（鼠）年，该年农历出现罕见的闰十月。这一年共366天
声明: 声明就是指公开表态或说明， 庄严声明，另指声明的文告， 发表声明。政党和国家的领导机关及其领导人、机关单位、社会团体、企事业单位、其他组织或公民个人均可发表声明。它是就有关事项或问题向社会表明自己立场、态度的应用文体
点的: 点的，拼音diǎn de，谓白色小点
光源: 太阳、打开的电灯、燃烧着的蜡烛等都是光源。自身正在发光的物体叫作光源。第二种是原子发光，荧光灯灯管内壁涂抹的荧光物质被电磁波能量激发而产生光，此外霓虹灯的原理也是一样
数字方块: 《数字方块》是一款益智类游戏，游戏大小为2244KB。它会让你陷入一个数字迷宫之中，如果你对你的头脑很有信心的话，现在就来尝试一下解决这些难题吧
污染指数: 污染指数（pollution index）指的是综合表示进料中悬浮物和胶体物质的浓度和过滤特性，表征进料对微孔滤膜堵塞程度的一个指标。是综合表示进料中悬浮物和胶体物质的浓度和过滤特性，表征进料对微孔滤膜堵塞程度的一个指标
空气调节: 空气调节又称空气调理，简称空调，是指用人为的方法处理室内空气的温度、湿度、洁净度和气流分布的技术。可使某些场所获得具有一定温度和一定湿度的空气，以满足使用者及生产过程的要求和改善劳动卫生和室内气候条件。一般比较合理的流程是：先使外界空气与控制温度的水充分接触，达到相应的饱和湿度，然后将这饱和空气加热使其达到所需要的温度。用人为的方法处理室内空气的温度、湿度、洁净度和气流分布的技术。空气调节又称空气调理，简称空调
R2R: R2R：即role to role（角色/角色）基于人综合的社会属性对应不同社会角色，用互联网交易角色可提供的资源，互联互通无所不容的庞大网络
偶数: 所有整数不是奇数（单数），就是偶数（双数）。整数中，能够被2整除的数，叫做偶数，正的偶数又称双数。若某数是2的倍数，它就是偶数，可表示为2n。在   中国文化里，偶有   一双一对、团圆的意思。所以运气不好叫做“   不偶”
运行环境: 运行环境（英语：Runtime environment，又称“运行期系统”，run-time system），指一种把半编译的运行码在目标机器上运行的环境。Java运行环境，称之为"Java Runtime Environment"(JRE)。一个由C#，Visual Basic .NET，C++.Net之类的语言写的程序运行于Microsoft Windows上的.NET Common Language Runtime(CLR)或Linux上的Mono。运行环境是一种介乎编译器及直译器的运行方式
大四: 讲述的是四个独立的故事，现在剧组正在拍摄第三个故事。他们中，有的放弃了医药代表的工作，走上艺术表演之路。这部微电影共9集，每集10分钟。整套影片预计在6月份结束拍摄，于2013年9月上映。也有大一就开始创业，现在成立一家桌游公司等
火灾: 所以说人类使用火的历史与同火灾作斗争的历史是相伴相生的，人们在用火的同时，不断总结火灾发生的规律，尽可能地减少火灾及其对人类造成的危害。火灾是指在时间或空间上失去控制的燃烧所造成的灾害。在各种灾害中，火灾是最经常、最普遍地威胁公众安全和社会发展的主要灾害之一。在各种灾害中，火灾是最经常、最普遍地威胁公众安全和社会发展的主要灾害之一。人类能够对火进行利用和控制，是文明进步的一个重要标志
俄文: 俄文的书写系统使用西里尔字母的修订版。分为元音和辅音两种，辅音又分为清辅音（声带不振动）和浊辅音（声带震动）。俄文的书写系统使用西里尔字母的修订版，共有33个字母，有印刷体和手写体的区别
传感器连接线: 传感器连接线也称为传感器连接器（带电缆），因为传感器上面的连接线最常使用的是传感器连接器（带电缆），即M12连接器-带电缆系列
小伙伴: 由于80后90后都是独生子女，因此他们比父一辈更孤单，他们的伙伴可能就不仅限制在人，范围已经扩大到宠物群体。正好小王来送情报，看到小荣无家可归，小王把她带回了部队，在这个大家庭里，小荣逐渐的成长，终于成为了一名优秀的八路军通讯员。只有12岁的小荣很羡慕小王是八路军，她也想参加八路军。故事简介：根据刘真同名小说改编。赵科长把小王和小荣送去学习，准备为革命事业担负更重的任务
元器件: 《元器件》是2009年电子工业出版社出版的图书，作者是姚金生。SIA认为，半导体市场销售回暖的主要原因有三：一是驱动半导体行业成长的两大应用市场表现良好，08年以来笔记本电脑和手机的出货量均好于预期。二是美国消费电子协会的数据显示，美国消费者用于购买耐用电子产品的消费比例在不断增长
A2: A2有限公司 (简称“A2C”)是一家迅速成长的乳制品公司， 旗下a2®牛奶及相关产品建立在独一无二的知识产权研发及专利技术上， 目前足迹遍及新西兰、澳大利亚、英国及中国。a2® 品牌牛奶是鲜奶产品，纯天然、无添加，源自含有纯A2 β-酪蛋白的奶牛。a2® 品牌牛奶背后的科研主张独树一帜，在全球消费者日益关注健康的趋势下， 带给消费者感受得到的健康益処。自2000年A2集团成立以来，A2有限公司（A2C）稳健发展，于2004年4月在新西兰证券交易所上市(新西兰证券交易所编号：ATM)
A5: A5和S5于2007年3月6日在欧洲接受预订，第一批成品预计6月交付用户使用。作为奥迪家族中的一个全新系列，定位于高档双门轿跑车这一充满激情的细分市场
接收装置: 接收装置由接收线圈和接收机两部分组成，是测量磁场的整套仪器设备
光照强度: 光照强度是一种物理术语，指单位面积上所接受可见光的光通量。照度的国际单位是每平方米所接受的烛光(中国大陆、港澳称坎德拉)。为物理术语，用于指示光照的强弱和物体表面积被照明程度的量。可通过   照度计来测量。在   光度学(photometry)中，“   光度”是发光强度在指定方向上的   密度，但经常会被误解为   照度
华泽: 华泽集团（VATS GROUP）成立于2006年3月，整合于有十余年历史的金六福企业，。并为社会创造更多就业机会，为消费者提供更多有价值的品牌，为员工营造快乐工作的氛围。华泽集团的愿景是让每一个消费者，在每一个幸福的时刻，在每一个期盼幸福的时刻，喝上幸福的美酒
小游戏: 小游戏是一个较模糊的概念，它是相对于体积庞大的单机游戏及网络游戏而言的，泛指所有体积较小、玩法简单的游戏，通常这类游戏以休闲益智类为主，有单机版有网页版，在网页上嵌入的多为FLASH格式。小游戏也可以理解为“Flash游戏”，是一个较模糊的概念，它是相对于体积庞大的单机游戏及网络游戏而言的，他不是一些大的游戏，没有必要花费更多的时间和精力。如植物大战僵尸，捕鱼达人，合金弹头等归纳其中，因其游戏安装简便，耐玩性强，无依赖性而广受白领及小朋友的喜爱。如植物大战僵尸，捕鱼达人，合金弹头等归纳其中，因其游戏安装简便，耐玩性强，无依赖性而广受白领及小朋友的喜爱。一般游戏大小小于10m的游戏都统称为小游戏，一些街机类小游戏
火柴人: 《火柴人》（Matchstick Men）是由华纳兄弟公司、ImageMovers等联合制作的剧情片。《火柴人》（Matchstick Men）是一部由尼古拉斯·凯奇、萨姆·洛克维尔和艾莉森·洛曼主演，瑞德雷·斯高特导演的影片。主人公罗伊是一名患有精神强迫症的骗子，他和野心勃勃的搭档弗兰克联手，经营着小打小闹的骗子生涯，依靠罗伊高明的骗术，屡屡有人受骗上当
视频网站: 除了传统的对视频网站的理解外，近年来，无论是P2P直播网站，BT下载站，还是本地视频播放软件，还将向影视点播扩展作为自己的一块战略要地
创客: 这个词译自英文单词“Mak-er”，源于美国麻省理工学院微观装配实验室的实验课题，此课题以创新为理念，以客户为中心，以个人设计、个人制造为核心内容，参与实验课题的学生即“创客”。创客以用户创新为核心理念，是创新2.0模式在设计制造领域的典型表现。“创客”一词来源于英文单词"Maker”，是指不以盈利为目标，努力把各种创意转变为现实的人
四旋翼飞行器: 在大学里，一些对四旋翼直升机感兴趣的大学生将数学算法运用到机器当中，创造出了极富智能的四旋翼直升机，TED讲坛中有所诠释。Seraphi集成易作、易维护的稳定设计，在出厂前已经设置并调试所有的飞行参数及功能，具有免安装、免调试的快速飞行模式。Seraphi 携带方便，可以搭配GoPro或者其它微型相机录制空中视频。四旋翼飞行器也称为四旋翼直升机，是一种有4个螺旋桨且螺旋桨呈十字形交叉的飞行器
儿童: 中国政府于1992年批准了《儿童权利公约》，并与各人民团体、国际组织、新闻媒体以及个人共同努力，把本公约规定的义务从单纯意向角度上的宣言转变成为改善所有中国儿童的生活的具体行动方案。社会和人们公认儿童的年龄段为0-14岁，因为此类人群都是正处学龄前和小学阶段，而且年龄比较幼小。是有史以来最为广泛认可的国际公约。国际《儿童权利公约》界定的儿童系指14岁以下的任何人，《儿童权利公约》由联合国1989年11月20日大会通过。《儿童权利公约》于1992年4月1日开始在我国正式生效
瓷片电容: 瓷片电容(ceramic capacitor)是一种用陶瓷材料作介质，在陶瓷表面涂覆一层金属薄膜，再经高温烧结后作为电极而成的电容器。高压瓷片电容就是以陶瓷材料为介质的圆板电容器，在“瓷片”电容器中一般DC50v以下叫低压，DC100V~500V为中高压，DC1000v~6000v和为高压，安规Y电容也是属于高压，DC6000v以上为超高压。三位数字的前两位数字为标称容量的有效数字，第三位数字表示有效数字后面零的个数，它们的单位都是pF
随机模型: 随机模型，一种非确定性模型，变量之间的关系是以统计值的形式给出的模型
标准时间: 所谓的标准时间，就是指在正常条件下，一位受过训练的熟练工作者，以规定的作业方法和用具，完成一定的质和量的工作所需的时间。这里的作业单位可以是一件，也可以是 一公斤、一吨、 一米、 一百米等等，具体应根据产品本身的特点和管理的需要加设定
Audio: 听觉声波作用于听觉器官，使其感受细胞兴奋并引起听神经的冲动发放传入信息，经各级听觉中枢分析后引起的感觉。Audio文件是Sun Micosystems公司推出的一种经过压缩的数字 声音格式，是Internet中常用的声音文件格式。Audio是英文单词，有多种含义：Audio是AU格式一种经过压缩的数字声音格式的详写。Audio是英文单词，有多种含义：Audio是AU格式一种经过压缩的数字声音格式的详写
电子元器件: 电子元器件包括：电阻、电容器、电位器、电子管、散热器、机电元件、连接器、半导体分立器件、电声器件、激光器件、电子显示器件、光电器件、传感器、电源、开关、微特电机、电子变压器、继电器、印制电路板、集成电路、各类电路、压电、晶体、石英、陶瓷磁性材料、印刷电路用基材基板、电子功能工艺专用材料、电子胶（带）制品、电子化学材料及部品等。电子器件：指在工厂生产加工时改变了分子结构的成品。因为它本身不产生电子，它对电压、电流无控制和变换作用，所以又称无源器件
文学作品: 文学作品(literature,literary works)，指散文或诗歌或小说或戏剧等形式的作品，尤指形式或表达优美并表现具有永久或普遍兴趣的作品。文学作品的基本特点是用形象反映社会生活，表达作者对人生、社会的认识和情感，以唤起人的美感，给人以艺术享受。以形象化方法，生动地描写人物形象，符合报告文学、故事或小说、散文体裁特征的，才归入文学类的有关类目
微型摄像头: 微型摄像头的出现，给人们的生活带来便利的同时，一些关系到企业机密、个人隐私等现象也随之产生。微型摄像头是现代高科技的产物，又名微型监控器，具有体积小、功能强大的特点，隐蔽性比较好。已经广泛运用到航空、商业、传媒、企事业单位、家庭等行业
事故: 事故（Accident），一般是指造成死亡、疾病、伤害、损坏或者其他损失的意外情况
电影院: 电影院必须满足电影放映的工艺要求，得到应有的良好视觉和听觉效果，现在电影已经成为人们饭后的论点。电影院必须满足电影放映的工艺要求，得到应有的良好视觉和听觉效果。电影院是为观众放映电影的场所。随着电影的进步与发展，出现了专门为放映电影而建造的电影院。电影在产生初期，是在咖啡厅、茶馆等场所放映的
舵机: 舵机的大小由外舾装按照船级社的规范决定，选型时主要考虑扭矩大小。如何审慎地选择经济且合乎需求的舵机，也是一门不可轻忽的学问。舵机是船舶上的一种大甲板机械。舵机是船舶上的一种大甲板机械。通常安装于船舶的尾部，由驾驶人员在驾驶台上通过操纵装置和传动装置远距离操纵
Tardis: TARDIS是英国科幻电视剧Doctor Who中的时间机器和宇宙飞船，它是时间和空间的相对维度（Time And Relative Dimension(s) In Space）的缩写。TARDIS是时间领主技术的产物，适当的维护驾驶，TARDIS能抵达任何时间空间点。TARDIS内部要比外部大，他的变色龙系统能够使它与周围的环境融为一体
喇叭: 喇叭分为几种不同的乐器，一种管乐器，上细下粗，多用铜制成。喇叭，是一种管乐器，上细下粗，多用铜制成，又可指一种电声元件，作用是将电信号转换为声音，也叫扬声器。分为带状，号角，气垫等等
青春舞曲: 1939年，中国西部歌王王洛宾在对西部音乐的整理时，搜集到这首新疆民歌，后将它编成汉语歌词，收录在《掀起你的盖头来-西部歌王王洛宾和他的歌》《百歌颂中华2》之中。而当今流传的版本并不是王洛宾手稿，而是歌唱家李谷一1981年录制的改版。作者王洛宾被称为西部歌王，他对西部音乐的整理、传播起到了不可估量的作用
遥控飞机: 随着科技的发达，遥控飞机大部分都一体机销售，而且厂家已经调试好，对于一些初学机型已经达到到手飞的状态，而且价格也相对较低。随着科技的发达，遥控飞机大部分都一体机销售，而且厂家已经调试好，对于一些初学机型已经达到到手飞的状态，而且价格也相对较低。顾名思义，遥控飞机即可以远距离控制飞行的飞行器
找东西: 《找东西》是2012年麦田出版社出版的图书，作者是水脑
控制继电器: 控制继电器的输入量通常是电流、电压等电量，也可以是温度、压力、速度等非电量，输出量则是触点动作时发出的电信号或输出电路的参数变化。控制继电器是一种自动电器，它适用于远距离接通和分断交、直流小容量控制电路，并在电力驱动系统中供控制、保护及信号转换用。控制继电器的特点是当其输入量的变化达到一定程序时，输出量才会发生阶跃性的变化
智能温度计: 智能温度计是一种可以根据患者体温情况提供治疗方案的新型温度计